"","county_state","pop","rural","urban","popden","land"
"1","Alabama Autauga County",54571,22921,31650,35.4453287620917,1539582278
"2","Alabama Baldwin County",182265,77060,105205,44.2657057374216,4117521611
"3","Alabama Barbour County",27457,18613,8844,11.9804401583956,2291818968
"4","Alabama Bibb County",22915,15663,7252,14.2110220204304,1612480789
"5","Alabama Blount County",57322,51562,5760,34.3253349340725,1669961855
"6","Alabama Bullock County",10914,5607,5307,6.76603532471162,1613056905
"7","Alabama Butler County",20947,14921,6026,10.4111533598954,2011976894
"8","Alabama Calhoun County",118572,39955,78617,75.5625516207806,1569189995
"9","Alabama Chambers County",34215,16816,17399,22.1454980229692,1545009282
"10","Alabama Cherokee County",25989,22282,3707,18.1224711032599,1434075952
"11","Alabama Chilton County",43643,37858,5785,24.3206459732979,1794483586
"12","Alabama Choctaw County",13859,13859,0,5.8576775450652,2365954748
"13","Alabama Clarke County",25833,19628,6205,8.05366117560256,3207609488
"14","Alabama Clay County",13932,13932,0,8.90649173290641,1564252280
"15","Alabama Cleburne County",14972,14972,0,10.3208709489884,1450652767
"16","Alabama Coffee County",49948,23573,26375,28.4032882473384,1758528786
"17","Alabama Colbert County",54428,23891,30537,35.4608142486654,1534877333
"18","Alabama Conecuh County",13228,10708,2520,6.00755321563689,2201894769
"19","Alabama Coosa County",11539,11539,0,6.84445167965552,1685891075
"20","Alabama Covington County",37765,26304,11461,14.1501860354165,2668869505
"21","Alabama Crenshaw County",13906,13906,0,8.81863515169637,1576888006
"22","Alabama Cullman County",80406,58889,21517,42.2471642555145,1903228333
"23","Alabama Dale County",50251,25572,24679,34.5754763041579,1453371157
"24","Alabama Dallas County",43820,19999,23821,17.2873095770599,2534807386
"25","Alabama DeKalb County",71109,64091,7018,35.3308142729568,2012662359
"26","Alabama Elmore County",79303,42973,36330,49.5065886509885,1601867593
"27","Alabama Escambia County",38319,24337,13982,15.6548046283079,2447746932
"28","Alabama Etowah County",104430,39144,65286,75.3670384515529,1385618994
"29","Alabama Fayette County",17241,13833,3408,10.6057238949763,1625631609
"30","Alabama Franklin County",31704,22309,9395,19.3130100505327,1641587713
"31","Alabama Geneva County",26790,24015,2775,18.007536648135,1487710425
"32","Alabama Greene County",9045,9045,0,5.3967553997709,1676007032
"33","Alabama Hale County",15760,14053,1707,9.44955211323482,1667803914
"34","Alabama Henry County",17302,15183,2119,11.8920116431083,1454926258
"35","Alabama Houston County",101547,34327,67220,67.6196639716821,1501737720
"36","Alabama Jackson County",53227,40994,12233,19.066400337325,2791664869
"37","Alabama Jefferson County",658466,64752,593714,228.777632689367,2878192209
"38","Alabama Lamar County",14564,14564,0,9.29689425884696,1566544654
"39","Alabama Lauderdale County",92709,45701,47008,53.6098436497178,1729327931
"40","Alabama Lawrence County",34339,31348,2991,19.1961684217514,1788846568
"41","Alabama Lee County",140247,38441,101806,89.129992890649,1573510728
"42","Alabama Limestone County",82782,47690,35092,57.0820459894948,1450228326
"43","Alabama Lowndes County",11299,11299,0,6.09373430320056,1854199648
"44","Alabama Macon County",21452,11916,9536,13.603000495214,1577005015
"45","Alabama Madison County",334811,55048,279763,161.267922740959,2076116529
"46","Alabama Marengo County",21027,14575,6452,8.31069777494764,2530112461
"47","Alabama Marion County",30776,27346,3430,16.0080991244384,1922526826
"48","Alabama Marshall County",93019,49550,43469,63.471549353771,1465522757
"49","Alabama Mobile County",412992,82682,330310,129.699455523261,3184223082
"50","Alabama Monroe County",23068,18234,4834,8.68365438238689,2656485275
"51","Alabama Montgomery County",229363,24063,205300,112.920461532797,2031190777
"52","Alabama Morgan County",119490,46120,73370,79.634712315643,1500476319
"53","Alabama Perry County",10591,10591,0,5.68210957338147,1863920409
"54","Alabama Pickens County",19746,19746,0,8.64976320677471,2282837059
"55","Alabama Pike County",32899,17002,15897,18.8996980249462,1740715643
"56","Alabama Randolph County",22913,18638,4275,15.2385920820764,1503616599
"57","Alabama Russell County",52947,18748,34199,31.8853003406348,1660545751
"58","Alabama Shelby County",195085,44762,150323,95.961047542345,2032960300
"59","Alabama St. Clair County",83593,60853,22740,51.0766280526409,1636619393
"60","Alabama Sumter County",13763,13763,0,5.87896727655924,2341057426
"61","Alabama Talladega County",82291,45931,36360,43.1240414581164,1908239516
"62","Alabama Tallapoosa County",41616,30890,10726,22.4250712486237,1855780057
"63","Alabama Tuscaloosa County",194656,49653,145003,56.8616114348626,3423328940
"64","Alabama Walker County",67023,49656,17367,32.707270412925,2049177420
"65","Alabama Washington County",17581,17581,0,6.28404039815235,2797722307
"66","Alabama Wilcox County",11670,11670,0,5.07126691593379,2301200113
"67","Alabama Winston County",24484,20785,3699,15.4219440943793,1587607882
"68","Alaska Aleutians East Borough",3141,3141,0,0.173697625050788,18083148800
"69","Alaska Aleutians West Census Area",5561,5561,0,0.489061304276414,11370762625
"70","Alaska Anchorage Municipality",291826,12015,279811,66.0971229579142,4415108963
"71","Alaska Bethel Census Area",17013,12579,4434,0.161911651620166,105075822708
"72","Alaska Bristol Bay Borough",997,997,0,0.764015582126151,1304947207
"73","Alaska Denali Borough",1826,1826,0,0.055289770794347,33026000538
"74","Alaska Dillingham Census Area",4847,4847,0,0.100784080989269,48092912615
"75","Alaska Fairbanks North Star Borough",97581,30124,67457,5.13425470368992,19005874393
"76","Alaska Haines Borough",2508,2508,0,0.417641765409084,6005146534
"77","Alaska Hoonah-Angoon Census Area",2150,2150,0,0.110316155840157,19489439091
"78","Alaska Juneau City and Borough",31275,6738,24537,4.46915406391312,6997968643
"79","Alaska Kenai Peninsula Borough",55400,43953,11447,1.3306139739193,41634915224
"80","Alaska Ketchikan Gateway Borough",13477,3125,10352,1.07102840791601,12583232994
"81","Alaska Kodiak Island Borough",13592,4257,9335,0.801257688731234,16963331761
"82","Alaska Lake and Peninsula Borough",1631,1631,0,0.0266249115708351,61258419419
"83","Alaska Matanuska-Susitna Borough",88995,44759,44236,1.39634694681037,63734160198
"84","Alaska Nome Census Area",9492,6270,3222,0.159608046673855,59470685832
"85","Alaska North Slope Borough",9430,5595,3835,0.0410499641532344,229720054439
"86","Alaska Northwest Arctic Borough",7523,4323,3200,0.0816540819637932,92132564828
"87","Alaska Petersburg Census Area",3815,3815,0,0.448808009789189,8500293927
"88","Alaska Prince of Wales-Hyder Census Area",5559,5559,0,0.547135238448818,10160193695
"89","Alaska Sitka City and Borough",8881,1854,7027,1.19462311373846,7434143788
"90","Alaska Skagway Municipality",968,968,0,0.826279937199788,1171515798
"91","Alaska Southeast Fairbanks Census Area",7029,7029,0,0.10956975389801,64150915284
"92","Alaska Valdez-Cordova Census Area",9636,9636,0,0.108659277179435,88680877051
"93","Alaska Wade Hampton Census Area",7459,7459,0,0.168600384709573,44240705695
"94","Alaska Wrangell City and Borough",2369,2369,0,0.359898521481529,6582411037
"95","Alaska Yakutat City and Borough",662,662,0,0.0334140890370648,19812002035
"96","Alaska Yukon-Koyukuk Census Area",5588,5588,0,0.0148279584087051,376855656455
"97","Arizona Apache County",71518,52967,18551,2.46601515536787,29001443825
"98","Arizona Cochise County",131346,47680,83666,8.22502815207756,15969063883
"99","Arizona Coconino County",134421,42297,92124,2.78750527087077,48222689085
"100","Arizona Gila County",53597,22008,31589,4.3493507319139,12322988718
"101","Arizona Graham County",37220,17284,19936,3.10879845913956,11972471194
"102","Arizona Greenlee County",8437,3929,4508,1.76740186277901,4773673819
"103","Arizona La Paz County",20489,11541,8948,1.75811116614577,11653984341
"104","Arizona Maricopa County",3817117,90229,3726888,160.192853720842,23828260196
"105","Arizona Mohave County",200186,45970,154216,5.80660838996179,34475546921
"106","Arizona Navajo County",107449,58171,49278,4.16929990656005,25771473007
"107","Arizona Pima County",980263,73750,906513,41.1973669384952,23794311939
"108","Arizona Pinal County",375770,82311,293459,27.0399025632996,13896869603
"109","Arizona Santa Cruz County",47420,12748,34672,14.8021043814054,3203598541
"110","Arizona Yavapai County",211033,70057,140976,10.0301975896867,21039764981
"111","Arizona Yuma County",195751,20416,175335,13.7069259888438,14281174361
"112","Arkansas Arkansas County",19019,6601,12418,7.4266786168599,2560902522
"113","Arkansas Ashley County",21853,11294,10559,9.11817487393887,2396641905
"114","Arkansas Baxter County",41513,27333,14180,28.9170800594282,1435587546
"115","Arkansas Benton County",221339,55689,165650,100.854147080845,2194644508
"116","Arkansas Boone County",36903,22953,13950,24.1402423858789,1528692190
"117","Arkansas Bradley County",11508,5707,5801,6.84388745931682,1681500473
"118","Arkansas Calhoun County",5368,5368,0,3.29726255249442,1628017155
"119","Arkansas Carroll County",27446,19990,7456,16.8182533745561,1631917381
"120","Arkansas Chicot County",11800,6405,5395,7.07120289326057,1668740125
"121","Arkansas Clark County",22995,12504,10491,10.2513375095474,2243121932
"122","Arkansas Clay County",16083,9466,6617,9.71074589196203,1656206452
"123","Arkansas Cleburne County",25970,19613,6357,18.109476241166,1434055831
"124","Arkansas Cleveland County",8689,8689,0,5.61213524204243,1548252069
"125","Arkansas Columbia County",24552,14114,10438,12.374582201921,1984066985
"126","Arkansas Conway County",21273,15001,6272,14.8728973955178,1430319825
"127","Arkansas Craighead County",96443,31024,65419,52.6534436875656,1831656075
"128","Arkansas Crawford County",61948,32189,29759,40.3279283972905,1536106675
"129","Arkansas Crittenden County",50902,10632,40270,32.2313134953417,1579271661
"130","Arkansas Cross County",17870,10148,7722,11.1938070993234,1596418434
"131","Arkansas Dallas County",8116,4272,3844,4.69533831619806,1728522942
"132","Arkansas Desha County",13008,4087,8921,6.53831207448176,1989504302
"133","Arkansas Drew County",18509,8997,9512,8.62716977252555,2145431293
"134","Arkansas Faulkner County",113237,43891,69346,67.4828033257687,1678012685
"135","Arkansas Franklin County",18125,14972,3153,11.4938346382955,1576932379
"136","Arkansas Fulton County",12245,11378,867,7.64779960769917,1601114128
"137","Arkansas Garland County",96024,35436,60588,54.7006637482125,1755444878
"138","Arkansas Grant County",17853,13395,4458,10.9100785077773,1636376859
"139","Arkansas Greene County",42090,17470,24620,28.1306364782872,1496233476
"140","Arkansas Hempstead County",22609,12609,10000,11.9988251563879,1884267810
"141","Arkansas Hot Spring County",32923,21719,11204,20.6625334047716,1593367055
"142","Arkansas Howard County",13789,9310,4479,9.04584279620726,1524346632
"143","Arkansas Independence County",36647,25134,11513,18.5214112811007,1978628920
"144","Arkansas Izard County",13696,13696,0,9.10828330939358,1503686209
"145","Arkansas Jackson County",17997,11709,6288,10.9611305144228,1641892684
"146","Arkansas Jefferson County",77435,23940,53495,34.3358863798981,2255220650
"147","Arkansas Johnson County",25540,18227,7313,14.9454337444792,1708883157
"148","Arkansas Lafayette County",7645,7645,0,5.58759944150961,1368208312
"149","Arkansas Lawrence County",17415,11069,6346,11.4428346946259,1521913098
"150","Arkansas Lee County",10424,6620,3804,6.67870950412641,1560780566
"151","Arkansas Lincoln County",14134,14134,0,9.7186238231736,1454321132
"152","Arkansas Little River County",13171,9025,4146,9.55438174222138,1378529805
"153","Arkansas Logan County",22353,15875,6478,12.1878845482247,1834034439
"154","Arkansas Lonoke County",68356,30632,37724,34.2434564869269,1996176993
"155","Arkansas Madison County",15717,15717,0,7.27399323289353,2160711386
"156","Arkansas Marion County",16653,16653,0,10.7699602863001,1546245256
"157","Arkansas Miller County",43462,17390,26072,26.8244254441616,1620239736
"158","Arkansas Mississippi County",46480,16857,29623,19.9273220980785,2332475973
"159","Arkansas Monroe County",8149,5621,2528,5.18239494660618,1572439014
"160","Arkansas Montgomery County",9487,9487,0,4.69681379301459,2019879948
"161","Arkansas Nevada County",8997,6224,2773,5.62245875620757,1600189595
"162","Arkansas Newton County",8330,8330,0,3.91795334598422,2126110054
"163","Arkansas Ouachita County",26120,14719,11401,13.762580266212,1897899921
"164","Arkansas Perry County",10445,10445,0,7.31378179386985,1428125735
"165","Arkansas Phillips County",21757,10436,11321,12.0754263084899,1801758335
"166","Arkansas Pike County",11291,11291,0,7.25832823062552,1555592368
"167","Arkansas Poinsett County",24583,17488,7095,12.515415794548,1964217602
"168","Arkansas Polk County",20662,15163,5499,9.30143380305582,2221377955
"169","Arkansas Pope County",61754,33652,28102,29.3439193482476,2104490517
"170","Arkansas Prairie County",8715,8715,0,5.19305199079864,1678203880
"171","Arkansas Pulaski County",382748,46989,335759,194.507772689111,1967777404
"172","Arkansas Randolph County",17969,12115,5854,10.6377940041482,1689166005
"173","Arkansas Saline County",107118,38734,68384,57.1562861328203,1874124567
"174","Arkansas Scott County",11233,7903,3330,4.86045950054595,2311098364
"175","Arkansas Searcy County",8195,8195,0,4.75023744782099,1725176918
"176","Arkansas Sebastian County",125744,26170,99574,91.274686948671,1377643728
"177","Arkansas Sevier County",17058,10849,6209,11.6542630102225,1463670417
"178","Arkansas Sharp County",17264,13821,3443,11.0278614038104,1565489388
"179","Arkansas St. Francis County",28258,14568,13690,17.1880564464484,1644048592
"180","Arkansas Stone County",12394,12394,0,7.89134563713522,1570581314
"181","Arkansas Union County",41639,22695,18944,15.470252438875,2691552718
"182","Arkansas Van Buren County",17295,17295,0,9.42978486744862,1834082139
"183","Arkansas Washington County",203065,51771,151294,83.2342134420238,2439681852
"184","Arkansas White County",77076,41866,35210,28.7507691649527,2680832626
"185","Arkansas Woodruff County",7260,7260,0,4.77700485985365,1519780744
"186","Arkansas Yell County",22185,17554,4631,9.21056430227927,2408647209
"187","California Alameda County",1510271,5869,1504402,789.046299412296,1914046110
"188","California Alpine County",1175,1175,0,0.614452367207212,1912271907
"189","California Amador County",38091,23016,15075,24.7350100116789,1539962991
"190","California Butte County",220000,41584,178416,51.9060951788789,4238423238
"191","California Calaveras County",45578,34370,11208,17.2525019662347,2641819725
"192","California Colusa County",21419,6795,14624,7.18666899348007,2980379369
"193","California Contra Costa County",1049025,8316,1040709,565.735118680493,1854268836
"194","California Del Norte County",28610,9634,18976,10.9764310144608,2606493856
"195","California El Dorado County",181058,62827,118231,40.9318937746637,4423396606
"196","California Fresno County",930450,100537,829913,60.2969592406372,15431126407
"197","California Glenn County",28122,11494,16628,8.26362569926848,3403106702
"198","California Humboldt County",134623,40062,94561,14.5679416953079,9241044673
"199","California Imperial County",174528,30399,144129,16.134077133271,10817352524
"200","California Inyo County",18546,8611,9935,0.703343100118215,26368354217
"201","California Kern County",839631,85693,753938,39.8655558641143,21061565098
"202","California Kings County",152982,16601,136381,42.5117412654161,3598582308
"203","California Lake County",64665,21408,43257,19.8710752224944,3254227528
"204","California Lassen County",34895,24610,10285,2.96685518019987,11761612172
"205","California Los Angeles County",9818605,59424,9759181,934.227095855012,10509869649
"206","California Madera County",150865,49672,101193,27.2566330210679,5534982985
"207","California Marin County",252409,16457,235952,187.304624505534,1347585521
"208","California Mariposa County",18251,18251,0,4.86379848421195,3752416976
"209","California Mendocino County",87841,39731,48110,9.67264206877234,9081386386
"210","California Merced County",255793,36510,219283,51.0406477070545,5011554741
"211","California Modoc County",9686,6776,2910,0.954570001596247,10146977156
"212","California Mono County",14202,6509,7693,1.79844376694696,7896827391
"213","California Monterey County",415057,40742,374315,48.8491845364592,8496702738
"214","California Napa County",136484,18290,118194,70.4161937045828,1938247338
"215","California Nevada County",98764,41614,57150,39.8142883313996,2480616988
"216","California Orange County",3010232,4315,3005917,1470.15491919752,2047561084
"217","California Placer County",348432,48039,300393,95.6144332633455,3644136017
"218","California Plumas County",20007,14810,5197,3.02570158002447,6612350713
"219","California Riverside County",2189641,101212,2088429,117.314577341901,18664696661
"220","California Sacramento County",1418788,29257,1389531,567.875080610586,2498415670
"221","California San Benito County",55269,13267,42002,15.3664053077328,3596742302
"222","California San Bernardino County",2035210,96357,1938853,39.1784127707406,51947229509
"223","California San Diego County",3095313,102054,2993259,284.100846608633,10895120648
"224","California San Francisco County",805235,0,805235,6632.90976456064,121399963
"225","California San Joaquin County",685306,58065,627241,190.177566064925,3603505998
"226","California San Luis Obispo County",269637,44750,224887,31.5614138147679,8543248461
"227","California San Mateo County",718451,13586,704865,618.62272231376,1161371825
"228","California Santa Barbara County",423895,21269,402626,59.8397364089249,7083838022
"229","California Santa Clara County",1781642,19307,1762335,533.211271453036,3341343470
"230","California Santa Cruz County",262382,31589,230793,227.567373477406,1152986019
"231","California Shasta County",177223,51902,125321,18.1242098523614,9778246966
"232","California Sierra County",3240,3231,9,1.31237114922847,2468813797
"233","California Siskiyou County",44900,29556,15344,2.76143667710247,16259652221
"234","California Solano County",413344,15370,397974,194.207637403937,2128361199
"235","California Sonoma County",483878,59776,424102,118.555992354735,4081430136
"236","California Stanislaus County",514453,41057,473396,132.879242129763,3871582888
"237","California Sutter County",94737,14019,80718,60.7196758869496,1560235601
"238","California Tehama County",63463,32676,30787,8.30699094850865,7639709781
"239","California Trinity County",13786,13786,0,1.67423067431264,8234229734
"240","California Tulare County",442179,68449,373730,35.389443554132,12494658169
"241","California Tuolumne County",55365,27110,28255,9.62524298544749,5752062580
"242","California Ventura County",823318,25725,797593,172.469865911784,4773691889
"243","California Yolo County",200849,13918,186931,76.425617655473,2628032408
"244","California Yuba County",72155,18921,53234,44.0922821749232,1636454192
"245","Colorado Adams County",441603,15988,425615,146.022708063902,3024207713
"246","Colorado Alamosa County",15445,5694,9751,8.25213481124692,1871636898
"247","Colorado Arapahoe County",572003,9011,562992,276.721633249305,2067070049
"248","Colorado Archuleta County",12084,7175,4909,3.45559467997862,3496937899
"249","Colorado Baca County",3788,3788,0,0.572436008632499,6617333541
"250","Colorado Bent County",6499,2467,4032,1.65863069283663,3918292377
"251","Colorado Boulder County",294567,26255,268312,156.594579313469,1881080439
"252","Colorado Broomfield County",55889,326,55563,653.232915608207,85557538
"253","Colorado Chaffee County",17809,6663,11146,6.78515060299933,2624702242
"254","Colorado Cheyenne County",1836,1836,0,0.398635341128029,4605713068
"255","Colorado Clear Creek County",9088,9088,0,8.87818475399702,1023632674
"256","Colorado Conejos County",8256,8256,0,2.47606255651725,3334326097
"257","Colorado Costilla County",3524,3524,0,1.10894679109944,3177789979
"258","Colorado Crowley County",5823,5823,0,2.85523572835244,2039411297
"259","Colorado Custer County",4255,4255,0,2.22421900110879,1913031045
"260","Colorado Delta County",30952,19553,11399,10.4641920566058,2957896781
"261","Colorado Denver County",600158,0,600158,1514.52327581413,396268588
"262","Colorado Dolores County",2064,2064,0,0.746838381831618,2763650142
"263","Colorado Douglas County",285465,29367,256098,131.173952579917,2176232357
"264","Colorado Eagle County",52197,10431,41766,11.9637985508769,4362911978
"265","Colorado El Paso County",622263,55595,566668,112.966406098615,5508389808
"266","Colorado Elbert County",23086,23086,0,4.81593316428679,4793671177
"267","Colorado Fremont County",46824,12371,34453,11.7925949617378,3970627343
"268","Colorado Garfield County",56389,13592,42797,7.38641140770335,7634153703
"269","Colorado Gilpin County",5441,5441,0,14.0149202464878,388229109
"270","Colorado Grand County",14843,12260,2583,3.10394985919506,4781971576
"271","Colorado Gunnison County",15324,8981,6343,1.82662793731486,8389228965
"272","Colorado Hinsdale County",843,843,0,0.291325777464195,2893667726
"273","Colorado Huerfano County",6711,3768,2943,1.62861750040179,4120672901
"274","Colorado Jackson County",1394,1394,0,0.333530867348413,4179523206
"275","Colorado Jefferson County",534543,36864,497679,270.068055934508,1979289991
"276","Colorado Kiowa County",1398,1398,0,0.305340476685692,4578495505
"277","Colorado Kit Carson County",8270,4027,4243,1.4777087204428,5596502129
"278","Colorado La Plata County",51334,30774,20560,11.7135056944504,4382462547
"279","Colorado Lake County",7310,2271,5039,7.48826343523098,976194289
"280","Colorado Larimer County",299630,34938,264692,44.5638347034513,6723613486
"281","Colorado Las Animas County",15507,6326,9181,1.25449370067359,12361162110
"282","Colorado Lincoln County",5467,5467,0,0.818900909195362,6676021407
"283","Colorado Logan County",22709,6621,16088,4.76898140353752,4761813494
"284","Colorado Mesa County",146723,18599,128124,17.0172758172545,8622002815
"285","Colorado Mineral County",712,712,0,0.313937745587722,2267965576
"286","Colorado Moffat County",13795,3774,10021,1.12290818918755,12285064917
"287","Colorado Montezuma County",25535,17155,8380,4.85784050918999,5256450876
"288","Colorado Montrose County",41276,18570,22706,7.11241521947555,5803373218
"289","Colorado Morgan County",28159,9165,18994,8.49107678804322,3316304952
"290","Colorado Otero County",18831,6479,12352,5.76141992932141,3268465106
"291","Colorado Ouray County",4436,4436,0,3.16242974379124,1402718909
"292","Colorado Park County",16206,16206,0,2.85214744265926,5682034441
"293","Colorado Phillips County",4442,4442,0,2.49308958027202,1781724987
"294","Colorado Pitkin County",17148,7580,9568,6.82074670630515,2514094239
"295","Colorado Prowers County",12551,4755,7796,2.95775431220683,4243422095
"296","Colorado Pueblo County",159063,22513,136550,25.7384290329815,6179980907
"297","Colorado Rio Blanco County",6666,6666,0,0.799071766302162,8342179365
"298","Colorado Rio Grande County",11982,7493,4489,5.07290572268775,2361959921
"299","Colorado Routt County",23509,10621,12888,3.8428347728221,6117619255
"300","Colorado Saguache County",6108,6108,0,0.744293435786113,8206440775
"301","Colorado San Juan County",699,699,0,0.6965008456153,1003588157
"302","Colorado San Miguel County",7359,7359,0,2.20837911588728,3332308274
"303","Colorado Sedgwick County",2379,2379,0,1.67603765811024,1419419181
"304","Colorado Summit County",27994,5464,22530,17.7667559888409,1575639358
"305","Colorado Teller County",23350,14618,8732,16.1841787656174,1442767059
"306","Colorado Washington County",4814,4814,0,0.738154458620211,6521670287
"307","Colorado Weld County",252825,51728,201097,24.4821805700916,10326898753
"308","Colorado Yuma County",10043,6519,3524,1.64000017643352,6123779829
"309","Connecticut Fairfield County",916829,42028,874801,566.483582158968,1618456437
"310","Connecticut Hartford County",894014,48354,845660,469.571824653487,1903891914
"311","Connecticut Litchfield County",189927,78722,111205,79.6593804535483,2384238980
"312","Connecticut Middlesex County",165676,40657,125019,173.213156771893,956486234
"313","Connecticut New Haven County",862477,31394,831083,550.870108775943,1565663096
"314","Connecticut New London County",274055,70729,203326,159.146846678387,1722025951
"315","Connecticut Tolland County",152691,58340,94351,143.716158032468,1062448385
"316","Connecticut Windham County",118428,58931,59497,89.1488160204219,1328430430
"317","Delaware Kent County",162310,43774,118536,106.909771596333,1518196116
"318","Delaware New Castle County",538479,24783,513696,487.719673499875,1104074798
"319","Delaware Sussex County",197145,81428,115717,81.3159243789184,2424432871
"320","Florida Alachua County",247336,52419,194917,109.136887048429,2266291505
"321","Florida Baker County",27115,16131,10984,17.888937768532,1515741200
"322","Florida Bay County",168852,20262,148590,85.9559900627154,1964400618
"323","Florida Bradford County",28520,21541,6979,37.4594405346394,761356806
"324","Florida Brevard County",543376,27573,515803,206.563025098685,2630557912
"325","Florida Broward County",1748066,296,1747770,557.894156581524,3133329108
"326","Florida Calhoun County",14625,9874,4751,9.95311469797334,1469389276
"327","Florida Charlotte County",159978,14213,145765,90.7978697901882,1761913582
"328","Florida Citrus County",141236,48753,92483,93.7457112271345,1506586255
"329","Florida Clay County",190865,28570,162295,121.936179169215,1565286048
"330","Florida Collier County",321520,27284,294236,62.1218316351559,5175636190
"331","Florida Columbia County",67531,41908,25623,32.6914605100983,2065707648
"332","Florida DeSoto County",34862,16121,18741,21.128794506975,1649975818
"333","Florida Dixie County",16422,12649,3773,8.99303943512028,1826078949
"334","Florida Duval County",864263,25163,839100,437.808059317405,1974068274
"335","Florida Escambia County",297619,24709,272910,175.046670706446,1700226567
"336","Florida Flagler County",95696,9877,85819,76.1100210247729,1257337716
"337","Florida Franklin County",11549,7858,3691,8.33904382254826,1384930964
"338","Florida Gadsden County",46389,30329,16060,34.688733134773,1337293000
"339","Florida Gilchrist County",16939,14215,2724,18.7035162853534,905658580
"340","Florida Glades County",12884,9101,3783,6.17181660955483,2087553927
"341","Florida Gulf County",15863,12228,3635,10.8592307120386,1460784877
"342","Florida Hamilton County",14799,9395,5404,11.1211218491746,1330711074
"343","Florida Hardee County",27731,13258,14473,16.787848363654,1651849564
"344","Florida Hendry County",39140,14831,24309,13.109552126343,2985609243
"345","Florida Hernando County",172778,33476,139302,141.1735913492,1223869127
"346","Florida Highlands County",98786,20810,77976,37.5181335018364,2633020110
"347","Florida Hillsborough County",1229226,43181,1186045,465.2033757242,2642341101
"348","Florida Holmes County",19927,15697,4230,16.0698007436077,1240027821
"349","Florida Indian River County",138028,6857,131171,105.977145316253,1302431761
"350","Florida Jackson County",49746,37490,12256,20.928171851172,2376987362
"351","Florida Jefferson County",14761,14761,0,9.5290106290423,1549059034
"352","Florida Lafayette County",8870,8870,0,6.30227501768818,1407428266
"353","Florida Lake County",297052,57194,239858,122.223702506814,2430396019
"354","Florida Lee County",618754,36013,582741,304.523017450236,2031879249
"355","Florida Leon County",275487,33911,241576,159.504846172908,1727138746
"356","Florida Levy County",40801,37557,3244,14.0880655484525,2896139279
"357","Florida Liberty County",8365,8365,0,3.86535645145805,2164095370
"358","Florida Madison County",19224,15381,3843,10.6651995234143,1802497924
"359","Florida Manatee County",322833,18693,304140,167.776728278546,1924182235
"360","Florida Marion County",331298,102796,228502,80.7265052919074,4103955681
"361","Florida Martin County",146318,12403,133915,103.951121469113,1407565382
"362","Florida Miami-Dade County",2496435,10095,2486340,507.915359877709,4915061046
"363","Florida Monroe County",73090,6369,66721,28.7000079615919,2546689189
"364","Florida Nassau County",73314,35298,38016,43.6401253710789,1679967676
"365","Florida Okaloosa County",180822,21878,158944,75.0507783126641,2409328778
"366","Florida Okeechobee County",39996,14618,25378,20.0837310612741,1991462636
"367","Florida Orange County",1145956,23402,1122554,489.7519679776,2339870128
"368","Florida Osceola County",268685,21014,247671,78.1495766253631,3438086444
"369","Florida Palm Beach County",1320134,13763,1306371,258.765419757111,5101663125
"370","Florida Pasco County",464697,43990,420707,240.224762376281,1934425891
"371","Florida Pinellas County",916542,2603,913939,1292.47726484373,709135878
"372","Florida Polk County",602095,81346,520749,129.305499256137,4656375819
"373","Florida Putnam County",74364,41765,32599,39.4601810302824,1884532662
"374","Florida Santa Rosa County",151372,31772,119600,57.7746079036457,2620043744
"375","Florida Sarasota County",379448,16394,363054,263.562165048022,1439690708
"376","Florida Seminole County",422718,13348,409370,527.81733044786,800879349
"377","Florida St. Johns County",190039,45179,144860,122.157395968787,1555689678
"378","Florida St. Lucie County",277789,9326,268463,187.532967962475,1481280881
"379","Florida Sumter County",93420,32664,60756,65.9490192564063,1416548738
"380","Florida Suwannee County",41551,34557,6994,23.2995248000487,1783341092
"381","Florida Taylor County",22570,15637,6933,8.3526156877352,2702147548
"382","Florida Union County",15535,10478,5057,24.6272091292219,630806354
"383","Florida Volusia County",494593,49179,445414,173.440461768586,2851658690
"384","Florida Wakulla County",30776,18982,11794,19.5948474449634,1570616974
"385","Florida Walton County",55043,34746,20297,20.4816048044023,2687435898
"386","Florida Washington County",24896,21050,3846,16.4933864918749,1509453502
"387","Georgia Appling County",18236,13028,5208,13.8852729429686,1313333924
"388","Georgia Atkinson County",8375,8375,0,9.52793234071785,878994487
"389","Georgia Bacon County",11096,7688,3408,16.568417192064,669707907
"390","Georgia Baker County",3451,3451,0,3.89666137147535,885629946
"391","Georgia Baldwin County",45720,16066,29654,68.4623761949382,667812053
"392","Georgia Banks County",18395,17260,1135,30.6016064214724,601112234
"393","Georgia Barrow County",69367,20853,48514,167.069416026122,415198674
"394","Georgia Bartow County",100157,35283,64874,84.1504358409404,1190213681
"395","Georgia Ben Hill County",17634,5996,11638,27.2209776925554,647809208
"396","Georgia Berrien County",19286,14685,4601,16.4780175031423,1170407787
"397","Georgia Bibb County",155547,22415,133132,240.457406761747,646879637
"398","Georgia Bleckley County",13063,6739,6324,23.3643280589971,559100179
"399","Georgia Brantley County",18411,18309,102,16.0694663750828,1145713216
"400","Georgia Brooks County",16243,11539,4704,12.7198308007997,1276982395
"401","Georgia Bryan County",30233,15825,14408,26.7750515463138,1129148153
"402","Georgia Bulloch County",70217,33903,36314,40.2951217771927,1742568254
"403","Georgia Burke County",23316,17486,5830,10.8859858231082,2141836337
"404","Georgia Butts County",23655,18437,5218,49.5313713520561,477576117
"405","Georgia Calhoun County",6694,6694,0,9.2185150909261,726147317
"406","Georgia Camden County",50513,15883,34630,31.8146456786856,1587727882
"407","Georgia Candler County",10998,7365,3633,17.4715453452863,629480666
"408","Georgia Carroll County",110527,46228,64299,85.5074858648607,1292600278
"409","Georgia Catoosa County",63942,17969,45973,152.246137322135,419990951
"410","Georgia Charlton County",12171,6210,5961,6.07470644943124,2003553604
"411","Georgia Chatham County",265128,11944,253184,240.050926346609,1104465640
"412","Georgia Chattahoochee County",11267,3326,7941,17.4892713983971,644223521
"413","Georgia Chattooga County",26015,14974,11041,32.056267536505,811541767
"414","Georgia Cherokee County",214346,36659,177687,196.264250551001,1092129613
"415","Georgia Clarke County",116714,6839,109875,378.048574567807,308727523
"416","Georgia Clay County",3183,3183,0,6.29006993654671,506035709
"417","Georgia Clayton County",259424,2303,257121,707.524676738113,366664243
"418","Georgia Clinch County",6798,4108,2690,3.2799910704728,2072566618
"419","Georgia Cobb County",688078,1694,686384,782.415064338316,879428364
"420","Georgia Coffee County",42356,28202,14154,28.4364837734338,1489494986
"421","Georgia Colquitt County",45498,26821,18677,32.2829514284115,1409350694
"422","Georgia Columbia County",124053,20131,103922,165.111408934159,751329062
"423","Georgia Cook County",17212,10226,6986,29.2549108864429,588345665
"424","Georgia Coweta County",127317,41929,85388,111.495221628417,1141905439
"425","Georgia Crawford County",12630,12630,0,15.0096897173292,841456435
"426","Georgia Crisp County",23439,11023,12416,33.200282670541,705987965
"427","Georgia Dade County",16633,11997,4636,36.912235263093,450609395
"428","Georgia Dawson County",22330,17933,4397,40.8939828275013,546046104
"429","Georgia Decatur County",27842,15724,12118,18.0022482274712,1546584607
"430","Georgia DeKalb County",691893,1820,690073,998.353669429041,693033963
"431","Georgia Dodge County",21796,15743,6053,16.9704662895745,1284348917
"432","Georgia Dooly County",14918,8006,6912,14.6957976004361,1015120132
"433","Georgia Dougherty County",94565,13201,81364,111.083122787167,851299438
"434","Georgia Douglas County",132403,20863,111540,255.519910242135,518170971
"435","Georgia Early County",11008,7260,3748,8.29157815443393,1327612162
"436","Georgia Echols County",4034,4034,0,3.75405386983735,1074571687
"437","Georgia Effingham County",52250,35035,17215,42.2312255782531,1237236175
"438","Georgia Elbert County",20166,14241,5925,22.1792367072769,909228765
"439","Georgia Emanuel County",22598,15114,7484,12.8197006524561,1762755669
"440","Georgia Evans County",11000,6741,4259,23.2270157440504,473586453
"441","Georgia Fannin County",23682,23682,0,23.643974200189,1001608266
"442","Georgia Fayette County",106567,19372,87195,211.717987333679,503344101
"443","Georgia Floyd County",96317,35466,60851,72.9308276636039,1320662374
"444","Georgia Forsyth County",175511,17414,158097,302.495219573826,580210822
"445","Georgia Franklin County",22084,19639,2445,32.6072329770525,677273046
"446","Georgia Fulton County",920581,9921,910660,674.924055143603,1363977166
"447","Georgia Gilmer County",28292,24796,3496,25.6097956943517,1104733530
"448","Georgia Glascock County",3082,3082,0,8.27862668456723,372283969
"449","Georgia Glynn County",79626,16376,63250,73.2425215228806,1087155362
"450","Georgia Gordon County",55186,28453,26733,59.8846149151665,921538864
"451","Georgia Grady County",25011,15597,9414,21.2458333254157,1177219063
"452","Georgia Greene County",15994,13235,2759,15.9389600454011,1003453171
"453","Georgia Gwinnett County",805321,3910,801411,722.463625607003,1114687261
"454","Georgia Habersham County",43041,25292,17749,60.050051447914,716752092
"455","Georgia Hall County",179684,36937,142747,176.628301071171,1017300166
"456","Georgia Hancock County",9429,5807,3622,7.7156523228574,1222061286
"457","Georgia Haralson County",28780,22264,6516,39.3812814264217,730804051
"458","Georgia Harris County",32024,30962,1062,26.6552531398634,1201414214
"459","Georgia Hart County",25213,18775,6438,41.8892236929171,601897046
"460","Georgia Heard County",11834,11834,0,15.4346886198562,766714528
"461","Georgia Henry County",203922,28250,175672,244.421535304241,834304554
"462","Georgia Houston County",139900,13937,125963,143.834482819486,972645761
"463","Georgia Irwin County",9538,6172,3366,10.3928773168242,917743923
"464","Georgia Jackson County",60485,36300,24185,68.7546022444921,879722928
"465","Georgia Jasper County",13900,11365,2535,14.5772183519125,953542690
"466","Georgia Jeff Davis County",15068,10474,4594,17.5902046720242,856613114
"467","Georgia Jefferson County",16930,13657,3273,12.4157617151875,1363589314
"468","Georgia Jenkins County",8340,5513,2827,9.27234344258471,899448996
"469","Georgia Johnson County",9980,6528,3452,12.7167226593862,784793399
"470","Georgia Jones County",28669,19413,9256,28.0991009194318,1020281755
"471","Georgia Lamar County",18317,11150,7167,38.5407973950638,475262611
"472","Georgia Lanier County",10078,7168,2910,21.0035159819063,479824426
"473","Georgia Laurens County",48434,27435,20999,23.1643405556936,2090886200
"474","Georgia Lee County",28298,10252,18046,30.7094390138089,921475641
"475","Georgia Liberty County",63453,14696,48757,50.0189674860276,1268578765
"476","Georgia Lincoln County",7996,7996,0,14.6747720079355,544880697
"477","Georgia Long County",14464,11765,2699,13.9512190648332,1036755278
"478","Georgia Lowndes County",109233,29716,79517,85.0190939328057,1284805506
"479","Georgia Lumpkin County",29966,25154,4812,40.8928516796605,732793111
"480","Georgia Macon County",14740,7840,6900,14.2051191508288,1037654091
"481","Georgia Madison County",28120,25836,2284,38.4582910314926,731181736
"482","Georgia Marion County",8742,8742,0,9.22206218431467,947944161
"483","Georgia McDuffie County",21875,13335,8540,32.8049305083222,666820495
"484","Georgia McIntosh County",14333,10651,3682,13.0426966739312,1098929183
"485","Georgia Meriwether County",21992,18316,3676,16.9408793960116,1298161653
"486","Georgia Miller County",6125,6125,0,8.37358631339792,731466754
"487","Georgia Mitchell County",23498,12809,10689,17.7170478641542,1326293194
"488","Georgia Monroe County",26424,21200,5224,25.7857827188714,1024750743
"489","Georgia Montgomery County",9123,9005,118,14.7059100881334,620362830
"490","Georgia Morgan County",17868,13467,4401,19.8614770906482,899630975
"491","Georgia Murray County",39628,27790,11838,44.4178602830802,892163642
"492","Georgia Muscogee County",189885,5654,184231,338.816905217963,560435436
"493","Georgia Newton County",99958,31231,68727,141.80561570837,704894510
"494","Georgia Oconee County",32808,16508,16300,68.7354585709437,477308229
"495","Georgia Oglethorpe County",14899,14788,111,13.1033818775008,1137034709
"496","Georgia Paulding County",142324,28540,113784,176.003455368138,808643215
"497","Georgia Peach County",27695,10586,17109,71.1604956928874,389190656
"498","Georgia Pickens County",29431,21515,7916,48.9679534202838,601025731
"499","Georgia Pierce County",18758,14885,3873,22.8835647250521,819714945
"500","Georgia Pike County",17869,17684,185,31.9283475634614,559659405
"501","Georgia Polk County",41475,21327,20148,51.6015556474946,803754838
"502","Georgia Pulaski County",12010,8011,3999,18.6205275647871,644987096
"503","Georgia Putnam County",21218,17175,4043,23.7707195015216,892610760
"504","Georgia Quitman County",2513,1837,676,6.41557367361557,391703085
"505","Georgia Rabun County",16276,12904,3372,16.9846581264753,958276574
"506","Georgia Randolph County",7719,3908,3811,6.95952865127544,1109126837
"507","Georgia Richmond County",200549,18483,182066,238.748801281291,840000029
"508","Georgia Rockdale County",85215,12725,72490,253.494087960994,336161686
"509","Georgia Schley County",5010,5010,0,11.5896070723696,432283853
"510","Georgia Screven County",14593,11517,3076,8.73412025404661,1670803650
"511","Georgia Seminole County",8729,5984,2745,14.3278577860268,609232736
"512","Georgia Spalding County",64073,26667,37406,125.916828901211,508851760
"513","Georgia Stephens County",26175,15329,10846,56.4179477434918,463948106
"514","Georgia Stewart County",6058,6058,0,5.09883809801798,1188113818
"515","Georgia Sumter County",32819,13713,19106,26.2514282997876,1250179595
"516","Georgia Talbot County",6865,6445,420,6.77227558737021,1013691766
"517","Georgia Taliaferro County",1717,1717,0,3.406531258061,504031776
"518","Georgia Tattnall County",25520,17414,8106,20.5533275182074,1241648097
"519","Georgia Taylor County",8906,8906,0,9.12862685208446,975612230
"520","Georgia Telfair County",16500,7753,8747,14.568114408647,1132610545
"521","Georgia Terrell County",9315,4849,4466,10.7218874634352,868783601
"522","Georgia Thomas County",44720,20581,24139,31.7051594858143,1410495980
"523","Georgia Tift County",40118,16361,23757,59.8253213056909,670585617
"524","Georgia Toombs County",27223,13899,13324,28.8756112957259,942767920
"525","Georgia Towns County",10471,10471,0,24.2723887287381,431395530
"526","Georgia Treutlen County",6885,4053,2832,13.3291622444969,516536589
"527","Georgia Troup County",67044,29700,37344,62.5279806278087,1072223976
"528","Georgia Turner County",8930,4441,4489,12.0812062862334,739164599
"529","Georgia Twiggs County",9023,9023,0,9.72047964128006,928246376
"530","Georgia Union County",21356,21356,0,25.6133138955514,833785120
"531","Georgia Upson County",27153,12737,14416,32.4138630299639,837697129
"532","Georgia Walker County",68756,30152,38604,59.4714846932896,1156117093
"533","Georgia Walton County",83768,35734,48034,99.3090626029343,843508113
"534","Georgia Ware County",36312,10691,25621,15.7095367839355,2311462171
"535","Georgia Warren County",5834,5834,0,7.92309306438631,736328597
"536","Georgia Washington County",21187,13899,7288,12.0573673204144,1757182927
"537","Georgia Wayne County",30099,17439,12660,18.1079911391515,1662194319
"538","Georgia Webster County",2799,2799,0,5.16789039443234,541613654
"539","Georgia Wheeler County",7421,7421,0,9.69683461370794,765301286
"540","Georgia White County",27144,22745,4399,43.5436163285853,623374958
"541","Georgia Whitfield County",102599,29833,72766,136.380951451229,752297142
"542","Georgia Wilcox County",9255,9255,0,9.46077015193442,978250169
"543","Georgia Wilkes County",10593,7136,3457,8.71153591059168,1215973866
"544","Georgia Wilkinson County",9563,9563,0,8.25448269596297,1158522024
"545","Georgia Worth County",21679,14994,6685,14.6666918239998,1478111101
"546","Hawaii Hawaii County",185079,70313,114766,17.7388322280682,10433550395
"547","Hawaii Honolulu County",953207,8225,944982,612.633519328048,1555917151
"548","Hawaii Kalawao County",90,90,0,2.89782304907203,31057797
"549","Hawaii Kauai County",67091,8628,58463,41.7835869822907,1605678326
"550","Hawaii Maui County",154834,22556,132278,51.4684858790714,3008326306
"551","Idaho Ada County",392365,21471,370894,143.925990480727,2726158067
"552","Idaho Adams County",3976,3976,0,1.1262503206308,3530298662
"553","Idaho Bannock County",82839,13030,69809,28.7631907457524,2880035137
"554","Idaho Bear Lake County",5986,5986,0,2.37099287360899,2524680722
"555","Idaho Benewah County",9285,6677,2608,4.61612041591532,2011429331
"556","Idaho Bingham County",45607,25554,20053,8.40933409230135,5423378296
"557","Idaho Blaine County",21376,7004,14372,3.12201668291736,6846856430
"558","Idaho Boise County",7028,7028,0,1.42874559636537,4919000288
"559","Idaho Bonner County",40877,29614,11263,9.09889540444843,4492523343
"560","Idaho Bonneville County",104234,13500,90734,21.5666205136836,4833116989
"561","Idaho Boundary County",10972,8359,2613,3.33946492715866,3285556291
"562","Idaho Butte County",2891,2891,0,0.500173839042333,5779990424
"563","Idaho Camas County",1117,1117,0,0.401376229328701,2782925142
"564","Idaho Canyon County",188923,37535,151388,124.186748298792,1521281478
"565","Idaho Caribou County",6963,4170,2793,1.52392709194521,4569116224
"566","Idaho Cassia County",22952,11823,11129,3.45479047947637,6643528786
"567","Idaho Clark County",982,982,0,0.214916392834202,4569218695
"568","Idaho Clearwater County",8761,5135,3626,1.37658298202618,6364309391
"569","Idaho Custer County",4368,4368,0,0.342717899022755,12745176171
"570","Idaho Elmore County",27038,7269,19769,3.39522658697479,7963533304
"571","Idaho Franklin County",12786,8463,4323,7.43877385576988,1718831658
"572","Idaho Fremont County",13242,9540,3702,2.74359827674787,4826508353
"573","Idaho Gem County",16719,7527,9192,11.508719324885,1452724628
"574","Idaho Gooding County",15464,8982,6482,8.19054191981218,1888031360
"575","Idaho Idaho County",16267,13117,3150,0.740882775955653,21956239945
"576","Idaho Jefferson County",26140,17412,8728,9.22972143059569,2832154816
"577","Idaho Jerome County",22374,11482,10892,14.4656280897841,1546700901
"578","Idaho Kootenai County",138494,33577,104917,42.9802878559951,3222267856
"579","Idaho Latah County",37244,13032,24212,13.3643561218535,2786815890
"580","Idaho Lemhi County",7936,4852,3084,0.671454474716429,11819118494
"581","Idaho Lewis County",3821,3821,0,3.0812685134916,1240073685
"582","Idaho Lincoln County",5208,5208,0,1.6737233108219,3111625420
"583","Idaho Madison County",37536,10684,26852,30.8877865517482,1215237613
"584","Idaho Minidoka County",20069,8875,11194,10.2280531932114,1962152486
"585","Idaho Nez Perce County",39265,7525,31740,17.8757801651843,2196547487
"586","Idaho Oneida County",4286,4286,0,1.37895827789891,3108143349
"587","Idaho Owyhee County",11526,8909,2617,0.580550141694907,19853582270
"588","Idaho Payette County",22623,9653,12970,21.4684214258243,1053780320
"589","Idaho Power County",7817,3329,4488,2.14931408572794,3636974257
"590","Idaho Shoshone County",12765,7153,5612,1.87422919791494,6810799882
"591","Idaho Teton County",10170,10170,0,8.73647990219101,1164084404
"592","Idaho Twin Falls County",77230,21617,55613,15.5207562314697,4975917336
"593","Idaho Valley County",9862,9862,0,1.03908413718193,9491050481
"594","Idaho Washington County",10198,4647,5551,2.70992426815294,3763204795
"595","Illinois Adams County",67103,21875,45228,30.2953062824584,2214963578
"596","Illinois Alexander County",8238,5096,3142,13.5056728449158,609965908
"597","Illinois Bond County",17768,10792,6976,18.0400681121819,984918676
"598","Illinois Boone County",54165,10488,43677,74.498688709608,727059777
"599","Illinois Brown County",6937,2849,4088,8.76416904580418,791518279
"600","Illinois Bureau County",34978,20074,14904,15.5403873078063,2250780454
"601","Illinois Calhoun County",5089,5089,0,7.74106814899923,657402816
"602","Illinois Carroll County",15387,12598,2789,13.3562452442138,1152045333
"603","Illinois Cass County",13642,7112,6530,14.0152969291574,973365036
"604","Illinois Champaign County",201081,25558,175523,77.9288202246265,2580316235
"605","Illinois Christian County",34800,15121,19679,18.9410557246877,1837278793
"606","Illinois Clark County",16335,9726,6609,12.5782870933144,1298666494
"607","Illinois Clay County",13815,8943,4872,11.3897525607214,1212932408
"608","Illinois Clinton County",37762,18412,19350,30.7539573967111,1227874498
"609","Illinois Coles County",53873,13085,40788,40.9224289672739,1316466333
"610","Illinois Cook County",5194675,2353,5192322,2121.67530670443,2448383588
"611","Illinois Crawford County",19817,11923,7894,17.2472543873634,1148994475
"612","Illinois Cumberland County",11048,11048,0,12.3276246753172,896198602
"613","Illinois De Witt County",16561,8074,8487,16.085594829217,1029554715
"614","Illinois DeKalb County",105160,21353,83807,64.315005217726,1635077221
"615","Illinois Douglas County",19980,12315,7665,18.5144602220089,1079156495
"616","Illinois DuPage County",916924,436,916488,1080.99992018683,848218379
"617","Illinois Edgar County",18576,9623,8953,11.5055013059614,1614531997
"618","Illinois Edwards County",6721,6721,0,11.6673053218709,576054180
"619","Illinois Effingham County",34242,20442,13800,27.6138940147232,1240027936
"620","Illinois Fayette County",22140,14831,7309,11.9309375963577,1855679809
"621","Illinois Ford County",14081,5883,8198,11.1954908744867,1257738509
"622","Illinois Franklin County",39561,19219,20342,37.3563181868126,1059017642
"623","Illinois Fulton County",37069,22251,14818,16.5347812712546,2241880276
"624","Illinois Gallatin County",5589,5589,0,6.67941101634865,836750424
"625","Illinois Greene County",13886,9838,4048,9.87333887046142,1406413796
"626","Illinois Grundy County",50063,12203,37860,46.2379256618268,1082725907
"627","Illinois Hamilton County",8457,5759,2698,7.51214190240455,1125777456
"628","Illinois Hancock County",19104,13559,5545,9.29300164651714,2055740516
"629","Illinois Hardin County",4320,4320,0,9.39550552769779,459794312
"630","Illinois Henderson County",7331,7306,25,7.47090213043816,981273730
"631","Illinois Henry County",50486,25382,25104,23.6854221043225,2131522072
"632","Illinois Iroquois County",29718,21320,8398,10.2694154642429,2893835594
"633","Illinois Jackson County",60218,22381,37837,39.8066128932329,1512763725
"634","Illinois Jasper County",9698,6775,2923,7.5719827104854,1280774187
"635","Illinois Jefferson County",38827,22819,16008,26.2465098883119,1479320495
"636","Illinois Jersey County",22985,13922,9063,24.0326271839958,956408129
"637","Illinois Jo Daviess County",22678,16462,6216,14.566980223132,1556808594
"638","Illinois Johnson County",12582,12582,0,14.1254013252509,890735754
"639","Illinois Kane County",515269,18335,496934,382.546915935999,1346943286
"640","Illinois Kankakee County",113449,27746,85703,64.7439799613692,1752271023
"641","Illinois Kendall County",114736,11955,102781,138.291990049616,829664827
"642","Illinois Knox County",52919,12870,40049,28.5207857734046,1855453788
"643","Illinois Lake County",703462,8915,694547,612.185283238169,1149099822
"644","Illinois LaSalle County",113924,34422,79502,38.7502195146499,2939957539
"645","Illinois Lawrence County",16833,9766,7067,17.4627618507839,963936870
"646","Illinois Lee County",36031,19173,16858,19.1912232827723,1877472815
"647","Illinois Livingston County",38950,15893,23057,14.4009290546231,2704686611
"648","Illinois Logan County",30305,12081,18224,18.9315785451922,1600764560
"649","Illinois Macon County",110768,16905,93863,73.6500783340606,1503976676
"650","Illinois Macoupin County",47765,27949,19816,21.3721552508634,2234917323
"651","Illinois Madison County",269282,35924,233358,145.294926589636,1853347576
"652","Illinois Marion County",39437,17769,21668,26.6032367395938,1482413602
"653","Illinois Marshall County",12640,12640,0,12.6175570629293,1001778707
"654","Illinois Mason County",14666,11364,3302,10.5010734179204,1396619128
"655","Illinois Massac County",15429,7793,7636,25.1126904926523,614390561
"656","Illinois McDonough County",32612,9622,22990,21.3630890322935,1526558259
"657","Illinois McHenry County",308760,30501,278259,197.643528522694,1562206475
"658","Illinois McLean County",169572,27974,141598,55.3264795223385,3064933852
"659","Illinois Menard County",12705,9617,3088,15.6006661303934,814388302
"660","Illinois Mercer County",16434,12779,3655,11.3064478199965,1453506907
"661","Illinois Monroe County",32957,13631,19326,33.0504189260187,997173442
"662","Illinois Montgomery County",30104,12530,17574,16.5176109295609,1822539599
"663","Illinois Morgan County",35547,12878,22669,24.1297417091748,1473161231
"664","Illinois Moultrie County",14846,10279,4567,17.0626233883909,870088946
"665","Illinois Ogle County",53497,25197,28300,27.2291163540555,1964698351
"666","Illinois Peoria County",186494,27313,159181,116.286567189746,1603744994
"667","Illinois Perry County",22350,9754,12596,19.5340682987346,1144154902
"668","Illinois Piatt County",16729,11319,5410,14.7064437092322,1137528578
"669","Illinois Pike County",16430,11880,4550,7.63026209409255,2153268105
"670","Illinois Pope County",4470,4470,0,4.6800889103817,955110060
"671","Illinois Pulaski County",6161,6161,0,11.9425509064656,515886434
"672","Illinois Putnam County",6006,6006,0,14.4787851769842,414813807
"673","Illinois Randolph County",33476,14275,19201,22.4590105814787,1490537612
"674","Illinois Richland County",16233,7056,9177,17.4104538278738,932370871
"675","Illinois Rock Island County",147546,16112,131434,133.215554047869,1107573369
"676","Illinois Saline County",24913,10878,14035,25.3251502577974,983725654
"677","Illinois Sangamon County",197465,27895,169570,87.805441621574,2248892510
"678","Illinois Schuyler County",7544,4348,3196,6.6611856928546,1132531106
"679","Illinois Scott County",5355,5355,0,8.2402204959286,649861251
"680","Illinois Shelby County",22363,17383,4980,11.3831791429128,1964565410
"681","Illinois St. Clair County",270056,26343,243713,158.521848868917,1703588508
"682","Illinois Stark County",5994,5994,0,8.03354194885281,746121703
"683","Illinois Stephenson County",47711,19129,28582,32.6316582733682,1462107736
"684","Illinois Tazewell County",135394,27645,107749,80.5516090227631,1680835450
"685","Illinois Union County",17808,11730,6078,16.6297103540183,1070854490
"686","Illinois Vermilion County",81625,25513,56112,35.0809171535554,2326763569
"687","Illinois Wabash County",11947,4647,7300,20.6617219899017,578218989
"688","Illinois Warren County",17707,8053,9654,12.6044303068425,1404823508
"689","Illinois Washington County",14716,10838,3878,10.099822074641,1457055371
"690","Illinois Wayne County",16760,11721,5039,9.06548778342331,1848769796
"691","Illinois White County",14665,9097,5568,11.4441670852983,1281438823
"692","Illinois Whiteside County",58498,21845,36653,33.0087106623256,1772198878
"693","Illinois Will County",677560,26624,650936,312.58812791748,2167580722
"694","Illinois Williamson County",66357,23091,43266,60.9797199363945,1088181449
"695","Illinois Winnebago County",295266,23368,271898,222.070999836459,1329601795
"696","Illinois Woodford County",38664,21221,17443,28.2839630652174,1366993724
"697","Indiana Adams County",34387,18457,15930,39.1616187009515,878079128
"698","Indiana Allen County",355329,42212,313117,208.719946961242,1702419942
"699","Indiana Bartholomew County",76794,25882,50912,72.8674397820362,1053886348
"700","Indiana Benton County",8854,8854,0,8.41142066140882,1052616479
"701","Indiana Blackford County",12766,6461,6305,29.8581714170532,427554649
"702","Indiana Boone County",56640,19487,37153,51.7100201473157,1095338966
"703","Indiana Brown County",15242,15242,0,18.8632352808082,808026819
"704","Indiana Carroll County",20155,16407,3748,20.9064629712689,964055949
"705","Indiana Cass County",38966,17405,21561,36.5029331904517,1067475860
"706","Indiana Clark County",110232,22614,87618,114.148297974443,965691140
"707","Indiana Clay County",26890,16373,10517,29.0379601558022,926029234
"708","Indiana Clinton County",33224,16540,16684,31.668251450221,1049126443
"709","Indiana Crawford County",10713,10713,0,13.5331629589849,791610951
"710","Indiana Daviess County",31648,19078,12570,28.4510605354414,1112366267
"711","Indiana Dearborn County",50047,26554,23493,63.3479489630383,790033471
"712","Indiana Decatur County",25740,13847,11893,26.6750647591345,964946111
"713","Indiana DeKalb County",42223,17860,24363,44.9319076907855,939710824
"714","Indiana Delaware County",117671,26843,90828,115.863953798113,1015596276
"715","Indiana Dubois County",41889,20629,21260,37.853022402492,1106622334
"716","Indiana Elkhart County",197559,40672,156887,164.686621513383,1199605640
"717","Indiana Fayette County",24277,8930,15347,43.5943579559542,556883990
"718","Indiana Floyd County",74578,15160,59418,194.644780726579,383149241
"719","Indiana Fountain County",17240,11370,5870,16.8237215230738,1024743543
"720","Indiana Franklin County",23087,20515,2572,23.1874315134272,995668709
"721","Indiana Fulton County",20836,13527,7309,21.8378900537509,954121481
"722","Indiana Gibson County",33503,17964,15539,26.5353014719217,1262582226
"723","Indiana Grant County",70061,20257,49804,65.3281728045934,1072446955
"724","Indiana Greene County",33165,24822,8343,23.6040580865316,1405055007
"725","Indiana Hamilton County",274569,15473,259096,268.882746987127,1021147705
"726","Indiana Hancock County",70002,21313,48689,88.3219408098102,792577692
"727","Indiana Harrison County",39364,33793,5571,31.3685002042463,1254889451
"728","Indiana Hendricks County",145448,25958,119490,138.009934041361,1053895149
"729","Indiana Henry County",49462,21197,28265,48.7332099044409,1014954691
"730","Indiana Howard County",82752,17821,64931,109.025808512396,759012945
"731","Indiana Huntington County",37124,18917,18207,37.4588325548401,991061319
"732","Indiana Jackson County",42376,18532,23844,32.1246281285843,1319112546
"733","Indiana Jasper County",33478,22778,10700,23.0974958886192,1449421191
"734","Indiana Jay County",21253,11828,9425,21.3746171255239,994310208
"735","Indiana Jefferson County",32428,14624,17804,34.7183979904219,934029272
"736","Indiana Jennings County",28525,17171,11354,29.2460201802994,975346383
"737","Indiana Johnson County",139654,19407,120247,168.277457342682,829903198
"738","Indiana Knox County",38440,13921,24519,28.7613840666969,1336514262
"739","Indiana Kosciusko County",77358,36047,41311,56.2084550667911,1376269814
"740","Indiana LaGrange County",37128,34015,3113,37.7615486111165,983222388
"741","Indiana Lake County",496005,19682,476323,383.814587183046,1292303671
"742","Indiana LaPorte County",111467,39713,71754,71.9333244712775,1549587772
"743","Indiana Lawrence County",46134,26964,19170,39.6565084481033,1163339936
"744","Indiana Madison County",131636,30393,101243,112.465691293671,1170454727
"745","Indiana Marion County",903393,5422,897971,880.149915652897,1026408097
"746","Indiana Marshall County",47051,29805,17246,40.9497878707254,1148992521
"747","Indiana Martin County",10334,7470,2864,11.8842391204684,869555038
"748","Indiana Miami County",36903,17155,19748,38.113220171038,968246709
"749","Indiana Monroe County",137974,29317,108657,135.033876616701,1021773228
"750","Indiana Montgomery County",38124,20112,18012,29.170397588242,1306941391
"751","Indiana Morgan County",68894,33853,35041,65.8469489013283,1046274750
"752","Indiana Newton County",14244,14244,0,13.6889088726713,1040550429
"753","Indiana Noble County",47536,32348,15188,44.6734226760436,1064077860
"754","Indiana Ohio County",6128,6128,0,27.4672732571326,223101869
"755","Indiana Orange County",19840,16558,3282,19.2281943882685,1031818152
"756","Indiana Owen County",21575,21575,0,21.6205634781618,997892586
"757","Indiana Parke County",17339,13000,4339,15.0555146465932,1151671026
"758","Indiana Perry County",19338,10644,8694,19.5596359463215,988668708
"759","Indiana Pike County",12845,12845,0,14.8381568787072,865673554
"760","Indiana Porter County",164343,34106,130237,151.74632496782,1083011401
"761","Indiana Posey County",25910,17298,8612,24.4253477148335,1060783261
"762","Indiana Pulaski County",13402,10848,2554,11.9325538649389,1123145988
"763","Indiana Putnam County",37963,24601,13362,30.5030990716376,1244562066
"764","Indiana Randolph County",26171,16191,9980,22.3367522672533,1171656456
"765","Indiana Ripley County",28818,23989,4829,24.923962368605,1156236700
"766","Indiana Rush County",17392,10637,6755,16.4535632381753,1057035473
"767","Indiana Scott County",24181,12747,11434,49.0360272626116,493127224
"768","Indiana Shelby County",44436,23128,21308,41.7291902554306,1064866098
"769","Indiana Spencer County",20952,20952,0,20.3899959847999,1027562733
"770","Indiana St. Joseph County",266931,24028,242903,225.101170297553,1185826798
"771","Indiana Starke County",23363,19247,4116,29.1799077903673,800653661
"772","Indiana Steuben County",34185,22989,11196,42.7232927333243,800149001
"773","Indiana Sullivan County",21475,16957,4518,18.5434368744564,1158091682
"774","Indiana Switzerland County",10613,10613,0,18.5724946142697,571436429
"775","Indiana Tippecanoe County",172780,25055,147725,133.473256587066,1294491529
"776","Indiana Tipton County",15936,9817,6119,23.6159644417553,674797764
"777","Indiana Union County",7516,7516,0,17.9994436457225,417568462
"778","Indiana Vanderburgh County",179703,16474,163229,297.178097969384,604697995
"779","Indiana Vermillion County",16212,9787,6425,24.3675239464807,665311750
"780","Indiana Vigo County",107848,25623,82225,103.245853951347,1044574633
"781","Indiana Wabash County",32888,16439,16449,30.7882353019042,1068200229
"782","Indiana Warren County",8508,6560,1948,9.00774341642345,944520687
"783","Indiana Warrick County",59689,17493,42196,59.8885848776289,996667397
"784","Indiana Washington County",28262,21718,6544,21.2409626823064,1330542331
"785","Indiana Wayne County",68917,22777,46140,66.2343189947042,1040502885
"786","Indiana Wells County",27636,13973,13663,28.9885714654882,953341217
"787","Indiana White County",24643,16749,7894,18.8363735496052,1308266686
"788","Indiana Whitley County",33292,23692,9600,38.3053726606904,869120901
"789","Iowa Adair County",7682,7682,0,5.21024029363042,1474404167
"790","Iowa Adams County",4029,4029,0,3.67374606286508,1096700733
"791","Iowa Allamakee County",14330,10599,3731,8.65748823527248,1655214493
"792","Iowa Appanoose County",12887,7507,5380,10.0055786283381,1287981483
"793","Iowa Audubon County",6119,6119,0,5.33355666341617,1147264459
"794","Iowa Benton County",26076,21032,5044,14.0562536986946,1855117342
"795","Iowa Black Hawk County",131090,17672,113418,89.4608364834571,1465333940
"796","Iowa Boone County",26306,13320,12986,17.7700397756259,1480356844
"797","Iowa Bremer County",24276,15655,8621,21.5235643331079,1127880105
"798","Iowa Buchanan County",20958,14364,6594,14.1710091786413,1478934897
"799","Iowa Buena Vista County",20260,8896,11364,13.6062409933577,1489022575
"800","Iowa Butler County",14867,14867,0,9.89462288522702,1502533262
"801","Iowa Calhoun County",9670,9670,0,6.55056284248017,1476209027
"802","Iowa Carroll County",20816,10832,9984,14.1141202358348,1474835105
"803","Iowa Cass County",13956,7485,6471,9.54941450319969,1461450856
"804","Iowa Cedar County",18499,15432,3067,12.3266570679819,1500731293
"805","Iowa Cerro Gordo County",44151,9092,35059,29.9954461218197,1471923432
"806","Iowa Cherokee County",12072,7410,4662,8.07934586365946,1494180371
"807","Iowa Chickasaw County",12439,9147,3292,9.52203259826332,1306338733
"808","Iowa Clarke County",9286,4467,4819,8.31545293052465,1116716080
"809","Iowa Clay County",16667,5715,10952,11.3447383618745,1469139214
"810","Iowa Clayton County",18129,17512,617,8.99075061689523,2016405612
"811","Iowa Clinton County",49116,15832,33284,27.2893761681833,1799821282
"812","Iowa Crawford County",17096,8856,8240,9.24236555507068,1849742893
"813","Iowa Dallas County",66135,20228,45907,43.3936543337647,1524070766
"814","Iowa Davis County",8753,8753,0,6.7296502058987,1300661956
"815","Iowa Decatur County",8457,8457,0,6.13908850452186,1377566066
"816","Iowa Delaware County",17764,12696,5068,11.8713069623913,1496381153
"817","Iowa Des Moines County",40325,10781,29544,37.4157444060679,1077754850
"818","Iowa Dickinson County",16667,5841,10826,16.9076917109824,985764366
"819","Iowa Dubuque County",93653,25302,68351,59.4432876668827,1575501687
"820","Iowa Emmet County",10302,4110,6192,10.0474663493704,1025333118
"821","Iowa Fayette County",20880,14737,6143,11.0313268576363,1892791345
"822","Iowa Floyd County",16303,8597,7706,12.573352726174,1296631086
"823","Iowa Franklin County",10680,6434,4246,7.0855109542205,1507301318
"824","Iowa Fremont County",7441,7441,0,5.6206301215386,1323872918
"825","Iowa Greene County",9336,5430,3906,6.32868132978521,1475188829
"826","Iowa Grundy County",12453,12453,0,9.58066105875049,1299805924
"827","Iowa Guthrie County",10954,10954,0,7.16088503842727,1529699184
"828","Iowa Hamilton County",15673,7912,7761,10.4921902583798,1493777716
"829","Iowa Hancock County",11341,7941,3400,7.66856343082399,1478894985
"830","Iowa Hardin County",17534,12464,5070,11.891499350228,1474498672
"831","Iowa Harrison County",14928,12109,2819,8.27114919218332,1804827800
"832","Iowa Henry County",20145,11509,8636,17.9081892925531,1124904348
"833","Iowa Howard County",9566,6026,3540,7.80447895588048,1225706425
"834","Iowa Humboldt County",9815,4572,5243,8.72469818968895,1124967281
"835","Iowa Ida County",7089,7089,0,6.3430585589144,1117599646
"836","Iowa Iowa County",16355,13441,2914,10.7675472832298,1518916014
"837","Iowa Jackson County",19848,10573,9275,12.0485660652355,1647332960
"838","Iowa Jasper County",36842,21187,15655,19.4747890128994,1891779160
"839","Iowa Jefferson County",16843,6523,10320,14.9322037037452,1127964789
"840","Iowa Johnson County",130882,24261,106621,82.2973209166121,1590355537
"841","Iowa Jones County",20638,11961,8677,13.8430990686878,1490851138
"842","Iowa Keokuk County",10511,10511,0,7.00701923201789,1500067240
"843","Iowa Kossuth County",15543,10203,5340,6.16949046159622,2519332852
"844","Iowa Lee County",35862,14566,21296,26.7553697721992,1340366450
"845","Iowa Linn County",211226,26927,184299,113.763556563507,1856710588
"846","Iowa Louisa County",11387,11387,0,10.943044661357,1040569636
"847","Iowa Lucas County",8898,5005,3893,7.97861149639081,1115231642
"848","Iowa Lyon County",11581,11581,0,7.60903137162045,1522007130
"849","Iowa Madison County",15679,10636,5043,10.7907820829741,1452999410
"850","Iowa Mahaska County",22381,9836,12545,15.1373560311286,1478527687
"851","Iowa Marion County",33309,16218,17091,23.1918506439471,1436237259
"852","Iowa Marshall County",40648,13790,26858,27.4135445238417,1482770678
"853","Iowa Mills County",15059,8971,6088,13.2917736991032,1132956394
"854","Iowa Mitchell County",10776,7241,3535,8.86877794180463,1215049026
"855","Iowa Monona County",9243,6581,2662,5.14174627104281,1797638295
"856","Iowa Monroe County",7970,4397,3573,7.09505877219531,1123316981
"857","Iowa Montgomery County",10740,5143,5597,9.77780826560303,1098405666
"858","Iowa Muscatine County",42745,10922,31823,37.7259247163846,1133040484
"859","Iowa O'Brien County",14398,9542,4856,9.7011490163389,1484154091
"860","Iowa Osceola County",6462,3772,2690,6.2580656789455,1032587437
"861","Iowa Page County",15932,5314,10618,11.4991440939919,1385494422
"862","Iowa Palo Alto County",9421,5793,3628,6.45119656004259,1460349241
"863","Iowa Plymouth County",24986,15726,9260,11.1800099296171,2234881736
"864","Iowa Pocahontas County",7310,7310,0,4.8894782536214,1495047042
"865","Iowa Polk County",430640,21139,409501,289.774455643168,1486121332
"866","Iowa Pottawattamie County",93158,24612,68546,37.850427443681,2461213949
"867","Iowa Poweshiek County",18914,9834,9080,12.4847531668158,1514967877
"868","Iowa Ringgold County",5131,5131,0,3.69952733985024,1386933932
"869","Iowa Sac County",10350,10350,0,6.94970008518922,1489272900
"870","Iowa Scott County",165224,22323,142901,139.25981211695,1186444226
"871","Iowa Shelby County",12167,7233,4934,7.95171373822177,1530110414
"872","Iowa Sioux County",33704,17130,16574,16.9369418543917,1989969635
"873","Iowa Story County",89542,15164,74378,60.3548331834895,1483592867
"874","Iowa Tama County",17767,12863,4904,9.51424131422261,1867411117
"875","Iowa Taylor County",6317,6317,0,4.58544913211563,1377618597
"876","Iowa Union County",12534,4917,7617,11.4232517747121,1097235730
"877","Iowa Van Buren County",7570,7570,0,6.02900143222234,1255597645
"878","Iowa Wapello County",35625,10854,24771,31.8523068374052,1118443326
"879","Iowa Warren County",46225,19394,26831,31.3210411268829,1475844938
"880","Iowa Washington County",21704,15076,6628,14.7317910631858,1473276393
"881","Iowa Wayne County",6403,6403,0,4.70506266550469,1360874542
"882","Iowa Webster County",38013,12891,25122,20.5093894057058,1853443769
"883","Iowa Winnebago County",10866,7185,3681,10.4756607076142,1037261544
"884","Iowa Winneshiek County",21056,12419,8637,11.7845241774577,1786750121
"885","Iowa Woodbury County",102172,17836,84336,45.1962582799322,2260629616
"886","Iowa Worth County",7598,7598,0,7.33174795429082,1036314948
"887","Iowa Wright County",13229,7514,5715,8.80005056280621,1503286817
"888","Kansas Allen County",13371,7642,5729,10.318888275529,1295779123
"889","Kansas Anderson County",8102,4766,3336,5.39674141875584,1501276302
"890","Kansas Atchison County",16924,5780,11144,15.1549659880575,1116729659
"891","Kansas Barber County",4861,4861,0,1.65495750132121,2937235546
"892","Kansas Barton County",27674,8788,18886,11.9332056488953,2319075093
"893","Kansas Bourbon County",15173,7278,7895,9.21887883676334,1645861744
"894","Kansas Brown County",9984,6833,3151,6.75255302708065,1478551884
"895","Kansas Butler County",65880,26664,39216,17.7893985718817,3703329246
"896","Kansas Chase County",2790,2790,0,1.39345547305184,2002216830
"897","Kansas Chautauqua County",3669,3669,0,2.21732946561535,1654693205
"898","Kansas Cherokee County",21603,10599,11004,14.195749482576,1521793550
"899","Kansas Cheyenne County",2726,2726,0,1.03199098262179,2641495949
"900","Kansas Clark County",2215,2215,0,0.877475785698167,2524286181
"901","Kansas Clay County",8535,4228,4307,5.10673558121869,1671322093
"902","Kansas Cloud County",9533,4193,5340,5.14538953933627,1852726587
"903","Kansas Coffey County",8601,6098,2503,5.2968860310319,1623784229
"904","Kansas Comanche County",1891,1891,0,0.92619739199242,2041681413
"905","Kansas Cowley County",36311,11256,25055,12.4536999168191,2915679697
"906","Kansas Crawford County",39134,13669,25465,25.6202801983345,1527461827
"907","Kansas Decatur County",2961,2961,0,1.27949221286455,2314199313
"908","Kansas Dickinson County",19754,12700,7054,9.00402985351962,2193906542
"909","Kansas Doniphan County",7945,5577,2368,7.79751125974366,1018914848
"910","Kansas Douglas County",110826,12205,98621,93.8646677690507,1180699859
"911","Kansas Edwards County",3037,3037,0,1.88551902551837,1610697086
"912","Kansas Elk County",2882,2882,0,1.72715713512129,1668637984
"913","Kansas Ellis County",28452,7272,21180,12.2071641269422,2330762469
"914","Kansas Ellsworth County",6497,3515,2982,3.50424942129171,1854034693
"915","Kansas Finney County",36776,6834,29942,10.9060296851001,3372079580
"916","Kansas Ford County",33848,6532,27316,11.8994205722907,2844508251
"917","Kansas Franklin County",25992,13542,12450,17.5521971868396,1480840246
"918","Kansas Geary County",34362,4011,30351,34.4945743082327,996156662
"919","Kansas Gove County",2695,2695,0,0.970961556141575,2775599078
"920","Kansas Graham County",2597,2597,0,1.11595208192686,2327160854
"921","Kansas Grant County",7829,1550,6279,5.2588631770984,1488724794
"922","Kansas Gray County",6006,6006,0,2.66891083644465,2250356182
"923","Kansas Greeley County",1247,1247,0,0.618497341771335,2016176814
"924","Kansas Greenwood County",6689,4098,2591,2.25893287465939,2961132699
"925","Kansas Hamilton County",2690,2690,0,1.04225475721831,2580942885
"926","Kansas Harper County",6034,6034,0,2.90756454065064,2075276375
"927","Kansas Harvey County",34684,10724,23960,24.8104882572182,1397957172
"928","Kansas Haskell County",4256,4256,0,2.84535141030902,1495773065
"929","Kansas Hodgeman County",1916,1916,0,0.860207651038115,2227369168
"930","Kansas Jackson County",13462,10217,3245,7.92071455807931,1699594134
"931","Kansas Jefferson County",19126,18900,226,13.8658528096893,1379359803
"932","Kansas Jewell County",3077,3077,0,1.30584869352465,2356321996
"933","Kansas Johnson County",544179,20862,523317,443.852942850375,1226034453
"934","Kansas Kearny County",3977,3977,0,1.76387328740921,2254697108
"935","Kansas Kingman County",7858,4880,2978,3.51415549842476,2236099115
"936","Kansas Kiowa County",2553,2553,0,1.36405398987243,1871626797
"937","Kansas Labette County",21607,11309,10298,12.9282175591636,1671305414
"938","Kansas Lane County",1750,1750,0,0.941771481240272,1858200248
"939","Kansas Leavenworth County",76227,22154,54073,63.5899647662777,1198726879
"940","Kansas Lincoln County",3241,3241,0,1.73945562008721,1863226611
"941","Kansas Linn County",9656,9656,0,6.27581493526992,1538604962
"942","Kansas Logan County",2756,2756,0,0.991708490475934,2779042457
"943","Kansas Lyon County",33690,8860,24830,15.3488843229934,2194947808
"944","Kansas Marion County",12660,9845,2815,5.17643002053254,2445700985
"945","Kansas Marshall County",10117,7180,2937,4.33933450141481,2331463499
"946","Kansas McPherson County",29180,12692,16488,12.5423374973093,2326520077
"947","Kansas Meade County",4575,4575,0,1.80599119994372,2533234935
"948","Kansas Miami County",32787,16705,16082,21.9905952554932,1490955548
"949","Kansas Mitchell County",6373,3078,3295,3.50620875793752,1817632788
"950","Kansas Montgomery County",35471,15403,20068,21.2818134582255,1666728264
"951","Kansas Morris County",5923,5923,0,3.28915965629784,1800763909
"952","Kansas Morton County",3233,3233,0,1.71058811711007,1889993253
"953","Kansas Nemaha County",10178,7658,2520,5.47756043958648,1858126462
"954","Kansas Neosho County",16512,7453,9059,11.1559540933975,1480106485
"955","Kansas Ness County",3107,3107,0,1.11618429426585,2783590502
"956","Kansas Norton County",5671,2778,2893,2.4934519581678,2274357034
"957","Kansas Osage County",16295,13612,2683,8.91760673601437,1827283988
"958","Kansas Osborne County",3858,3858,0,1.66899272902798,2311573881
"959","Kansas Ottawa County",6091,6091,0,3.26299585679132,1866689468
"960","Kansas Pawnee County",6973,2209,4764,3.56943264423524,1953531750
"961","Kansas Phillips County",5642,3033,2609,2.45901977193153,2294410181
"962","Kansas Pottawatomie County",21604,12728,8876,9.91811781617658,2178235871
"963","Kansas Pratt County",9656,3110,6546,5.07207543153602,1903757176
"964","Kansas Rawlins County",2519,2519,0,0.909459893009528,2769775797
"965","Kansas Reno County",64511,20191,44320,19.8414042855426,3251332369
"966","Kansas Republic County",4980,4980,0,2.6803278751655,1857981647
"967","Kansas Rice County",10083,6431,3652,5.36060395499916,1880944775
"968","Kansas Riley County",71115,9846,61269,45.0294383776289,1579300177
"969","Kansas Rooks County",5181,5181,0,2.24628964263212,2306470146
"970","Kansas Rush County",3307,3307,0,1.77891572057241,1858997569
"971","Kansas Russell County",6970,2862,4108,3.0365042740928,2295402664
"972","Kansas Saline County",55606,8113,47493,29.8095792905606,1865373525
"973","Kansas Scott County",4936,1289,3647,2.65600490480164,1858430303
"974","Kansas Sedgwick County",498365,38168,460197,192.899755596495,2583543968
"975","Kansas Seward County",22952,2623,20329,13.8574703244917,1656290756
"976","Kansas Shawnee County",177934,28157,149777,126.284253078625,1408995941
"977","Kansas Sheridan County",2556,2556,0,1.10147799083433,2320518450
"978","Kansas Sherman County",6010,1457,4553,2.19728050649625,2735199253
"979","Kansas Smith County",3853,3853,0,1.66131758407713,2319243495
"980","Kansas Stafford County",4437,4437,0,2.16292394184277,2051389748
"981","Kansas Stanton County",2235,2235,0,1.2683829025383,1762086193
"982","Kansas Stevens County",5724,1788,3936,3.03873414532231,1883679100
"983","Kansas Sumner County",24132,15168,8964,7.88315099670738,3061212453
"984","Kansas Thomas County",7900,2437,5463,2.83822954827726,2783425324
"985","Kansas Trego County",3001,3001,0,1.30266629985679,2303736575
"986","Kansas Wabaunsee County",7053,7053,0,3.42839328294839,2057231892
"987","Kansas Wallace County",1485,1485,0,0.62754926570228,2366348080
"988","Kansas Washington County",5799,5799,0,2.50236659627138,2317406254
"989","Kansas Wichita County",2234,2234,0,1.20037689728273,1861082136
"990","Kansas Wilson County",9409,6839,2570,6.36871949021913,1477377048
"991","Kansas Woodson County",3309,3309,0,2.56641479742063,1289347304
"992","Kansas Wyandotte County",157505,9549,147956,401.14113721196,392642353
"993","Kentucky Adair County",18656,14077,4579,17.773080054977,1049677374
"994","Kentucky Allen County",19956,15705,4251,22.3764591468844,891830109
"995","Kentucky Anderson County",21421,8932,12489,40.9781167521162,522742422
"996","Kentucky Ballard County",8249,8249,0,12.9123941066675,638843574
"997","Kentucky Barren County",42173,26685,15488,33.3984109100553,1262724748
"998","Kentucky Bath County",11591,11591,0,16.0525089519605,722067811
"999","Kentucky Bell County",28691,17926,10765,30.8569480824239,929806795
"1000","Kentucky Boone County",118811,15769,103042,186.204484310386,638067340
"1001","Kentucky Bourbon County",19985,8943,11042,26.6335424736976,750369577
"1002","Kentucky Boyd County",49542,12543,36999,119.653311738578,414046208
"1003","Kentucky Boyle County",28432,9900,18532,60.9298502474704,466634989
"1004","Kentucky Bracken County",8488,8488,0,15.9389112458346,532533237
"1005","Kentucky Breathitt County",13878,11311,2567,10.8817658425902,1275344480
"1006","Kentucky Breckinridge County",20059,20059,0,13.6551531503678,1468969244
"1007","Kentucky Bullitt County",74319,22603,51716,96.6074872849993,769288200
"1008","Kentucky Butler County",12690,12690,0,11.499124088883,1103562315
"1009","Kentucky Caldwell County",12984,7094,5890,14.5396777660712,893004660
"1010","Kentucky Calloway County",37191,18119,19072,37.2953963036529,997200826
"1011","Kentucky Campbell County",90336,13818,76518,230.515648010322,391886628
"1012","Kentucky Carlisle County",5104,5104,0,10.4028997838565,490632430
"1013","Kentucky Carroll County",10811,5646,5165,32.466195808627,332992509
"1014","Kentucky Carter County",27720,22004,5716,26.1364072881153,1060589533
"1015","Kentucky Casey County",15955,15955,0,13.8672813718881,1150549958
"1016","Kentucky Christian County",73955,21118,52837,39.7966074416466,1858324233
"1017","Kentucky Clark County",35613,9782,25831,54.4643440858721,653877332
"1018","Kentucky Clay County",21730,17073,4657,17.8796971088471,1215344973
"1019","Kentucky Clinton County",10272,10272,0,20.1071049811976,510864195
"1020","Kentucky Crittenden County",9315,6597,2718,9.99173082640567,932270911
"1021","Kentucky Cumberland County",6856,6856,0,8.67390356317582,790416904
"1022","Kentucky Daviess County",96656,26113,70543,81.4211805591529,1187111257
"1023","Kentucky Edmonson County",12161,12161,0,15.5022991461011,784464284
"1024","Kentucky Elliott County",7852,7852,0,12.9384408904205,606873739
"1025","Kentucky Estill County",14672,11169,3503,22.3839851642266,655468626
"1026","Kentucky Fayette County",295803,9072,286731,402.64560470921,734648526
"1027","Kentucky Fleming County",14348,11553,2795,15.8941851557851,902720074
"1028","Kentucky Floyd County",39451,33088,6363,38.7245933892173,1018758276
"1029","Kentucky Franklin County",49285,13580,35705,91.5973753167504,538061269
"1030","Kentucky Fulton County",6813,4390,2423,12.8003285541664,532251963
"1031","Kentucky Gallatin County",8589,8589,0,32.7580636220025,262194985
"1032","Kentucky Garrard County",16912,13173,3739,28.380722362786,595897447
"1033","Kentucky Grant County",24662,16028,8634,36.9122511838012,668125059
"1034","Kentucky Graves County",37121,25765,11356,25.9767808432807,1429006936
"1035","Kentucky Grayson County",25746,18944,6802,20.0133411547102,1286441869
"1036","Kentucky Green County",11258,11258,0,15.1965652976345,740825297
"1037","Kentucky Greenup County",36910,14501,22409,41.3796915178191,891983450
"1038","Kentucky Hancock County",8565,7649,916,17.6228231299708,486017475
"1039","Kentucky Hardin County",105543,36109,69434,65.3807673510648,1614282063
"1040","Kentucky Harlan County",29278,15856,13422,24.2671347075685,1206487719
"1041","Kentucky Harrison County",18846,12425,6421,23.7510886214933,793479419
"1042","Kentucky Hart County",18199,15867,2332,17.0514781971797,1067297497
"1043","Kentucky Henderson County",46250,17667,28583,40.8941696132839,1130968068
"1044","Kentucky Henry County",15416,15416,0,20.7916868793643,741450181
"1045","Kentucky Hickman County",4902,4902,0,7.81210439966277,627487774
"1046","Kentucky Hopkins County",46920,22111,24809,33.4244990820028,1403760753
"1047","Kentucky Jackson County",13494,13494,0,15.0928587969711,894065212
"1048","Kentucky Jefferson County",741096,10176,730920,752.172504333576,985273984
"1049","Kentucky Jessamine County",48586,12583,36003,108.991679891997,445777146
"1050","Kentucky Johnson County",23356,17054,6302,34.4252373224804,678455744
"1051","Kentucky Kenton County",159720,11142,148578,384.825760330844,415044980
"1052","Kentucky Knott County",16346,16346,0,17.9542044109348,910427420
"1053","Kentucky Knox County",31883,20062,11821,31.8669022431305,1000505156
"1054","Kentucky Larue County",14193,10780,3413,20.954288876544,677331504
"1055","Kentucky Laurel County",58849,33451,25398,52.3598899760953,1123932843
"1056","Kentucky Lawrence County",15860,12229,3631,14.7344824248924,1076386638
"1057","Kentucky Lee County",7887,7887,0,14.5802364619311,540937729
"1058","Kentucky Leslie County",11310,11310,0,10.8940486316091,1038181523
"1059","Kentucky Letcher County",24519,24519,0,28.0155442383045,875192707
"1060","Kentucky Lewis County",13870,13870,0,11.0912060080988,1250540292
"1061","Kentucky Lincoln County",24742,20204,4538,28.5935147229772,865301109
"1062","Kentucky Livingston County",9519,9079,440,11.7374208667839,810995883
"1063","Kentucky Logan County",26835,20121,6714,18.7655541164147,1430013728
"1064","Kentucky Lyon County",8314,8314,0,15.0114637460548,553843392
"1065","Kentucky Madison County",82916,31937,50979,73.2096452392026,1132583005
"1066","Kentucky Magoffin County",13333,13333,0,16.6899137733812,798865721
"1067","Kentucky Marion County",19820,14174,5646,22.3100903090393,888387260
"1068","Kentucky Marshall County",31448,27001,4447,40.3055102824544,780240711
"1069","Kentucky Martin County",12929,12929,0,21.7413361019465,594673664
"1070","Kentucky Mason County",17490,9689,7801,28.1222521864364,621927429
"1071","Kentucky McCracken County",65565,18243,47322,101.770604243083,644243006
"1072","Kentucky McCreary County",18306,18306,0,16.5603013779449,1105414665
"1073","Kentucky McLean County",9531,9531,0,14.5755044445448,653905327
"1074","Kentucky Meade County",28602,24569,4033,36.1573323171288,791042872
"1075","Kentucky Menifee County",6306,6306,0,11.9594364363833,527282371
"1076","Kentucky Mercer County",21331,12616,8715,33.103042964674,644381848
"1077","Kentucky Metcalfe County",10099,10099,0,13.4621342994355,750178224
"1078","Kentucky Monroe County",10963,10963,0,12.8511822938837,853073262
"1079","Kentucky Montgomery County",26499,15664,10835,51.8394035349896,511174863
"1080","Kentucky Morgan County",13923,13923,0,14.1047603167939,987113548
"1081","Kentucky Muhlenberg County",31499,21556,9943,26.0380699364439,1209728681
"1082","Kentucky Nelson County",43437,24735,18702,40.1691674870265,1081351761
"1083","Kentucky Nicholas County",7135,7135,0,14.1150285048797,505489592
"1084","Kentucky Ohio County",23842,17521,6321,15.6748795972571,1521032417
"1085","Kentucky Oldham County",60316,12261,48055,124.390202942979,484893493
"1086","Kentucky Owen County",10841,10841,0,11.9216793197058,909351754
"1087","Kentucky Owsley County",4755,4755,0,9.30014177992799,511282528
"1088","Kentucky Pendleton County",14877,14877,0,20.7248640808261,717833417
"1089","Kentucky Perry County",28712,21268,7444,32.6368956046796,879740535
"1090","Kentucky Pike County",65024,57090,7934,31.9075499311066,2037887589
"1091","Kentucky Powell County",12613,8464,4149,27.2093054866949,463554647
"1092","Kentucky Pulaski County",63063,34021,29042,36.9812798249311,1705268187
"1093","Kentucky Robertson County",2282,2282,0,8.8187104345629,258767993
"1094","Kentucky Rockcastle County",17056,14279,2777,20.8038808117419,819847035
"1095","Kentucky Rowan County",23333,16051,7282,32.1982604971528,724666477
"1096","Kentucky Russell County",17565,17565,0,26.7364111383654,656969251
"1097","Kentucky Scott County",47173,15314,31859,64.6408741352536,729770453
"1098","Kentucky Shelby County",42074,19778,22296,42.7905888302744,983253588
"1099","Kentucky Simpson County",17327,7835,9492,28.56481294483,606585453
"1100","Kentucky Spencer County",17061,17061,0,35.2870265895119,483492140
"1101","Kentucky Taylor County",24512,12793,11719,35.5357504828517,689784222
"1102","Kentucky Todd County",12460,12460,0,12.8461480419917,969940558
"1103","Kentucky Trigg County",14339,11379,2960,12.5416847347526,1143307323
"1104","Kentucky Trimble County",8809,8342,467,22.4280995077209,392766226
"1105","Kentucky Union County",15007,9797,5210,16.9002640830964,887974290
"1106","Kentucky Warren County",113792,35486,78306,81.1213509160696,1402737981
"1107","Kentucky Washington County",11717,11717,0,15.2185404950004,769916143
"1108","Kentucky Wayne County",20813,14097,6716,17.5392084082572,1186655607
"1109","Kentucky Webster County",13621,13621,0,15.8433762971168,859728365
"1110","Kentucky Whitley County",35637,23220,12417,31.42664987511,1133973877
"1111","Kentucky Wolfe County",7355,7355,0,12.7819801045204,575419453
"1112","Kentucky Woodford County",24939,9017,15922,51.0053907169796,488948318
"1113","Louisiana Acadia Parish",61773,31936,29837,36.406647646287,1696750566
"1114","Louisiana Allen Parish",25764,17886,7878,13.057130625151,1973174715
"1115","Louisiana Ascension Parish",107215,14170,93045,142.754076622168,751046853
"1116","Louisiana Assumption Parish",23421,10538,12883,26.7021354388949,877120860
"1117","Louisiana Avoyelles Parish",42073,26835,15238,19.5144283689838,2155994488
"1118","Louisiana Beauregard Parish",35654,23708,11946,11.8945709864926,2997501973
"1119","Louisiana Bienville Parish",14353,11459,2894,6.83094020515099,2101174885
"1120","Louisiana Bossier Parish",116979,28475,88504,53.7652061492896,2175737961
"1121","Louisiana Caddo Parish",254969,36805,218164,112.054336151333,2275405029
"1122","Louisiana Calcasieu Parish",192768,39518,153250,69.9736832370616,2754864273
"1123","Louisiana Caldwell Parish",10132,10132,0,7.38912767618942,1371203807
"1124","Louisiana Cameron Parish",6839,6839,0,2.05508545838793,3327842145
"1125","Louisiana Catahoula Parish",10407,10407,0,5.67513411163429,1833789263
"1126","Louisiana Claiborne Parish",17195,14161,3034,8.79483003238325,1955125902
"1127","Louisiana Concordia Parish",20822,6966,13856,11.5356442345978,1805014057
"1128","Louisiana De Soto Parish",26656,20595,6061,11.754438294177,2267739158
"1129","Louisiana East Baton Rouge Parish",440171,30266,409905,373.212217215474,1179412087
"1130","Louisiana East Carroll Parish",7759,2683,5076,7.12083734997415,1089619046
"1131","Louisiana East Feliciana Parish",20267,20267,0,17.2584169843349,1174325549
"1132","Louisiana Evangeline Parish",33984,20762,13222,19.8093866369381,1715550341
"1133","Louisiana Franklin Parish",20767,15406,5361,12.8376178197149,1617667724
"1134","Louisiana Grant Parish",22309,19095,3214,13.3953482295022,1665428895
"1135","Louisiana Iberia Parish",73240,20607,52633,49.2555033029584,1486940445
"1136","Louisiana Iberville Parish",33387,19770,13617,20.8377484120246,1602236448
"1137","Louisiana Jackson Parish",16274,10665,5609,11.0393715067239,1474178126
"1138","Louisiana Jefferson Davis Parish",31594,16018,15576,18.7286767236922,1686931782
"1139","Louisiana Jefferson Parish",432552,4942,427610,564.923340714229,765682649
"1140","Louisiana La Salle Parish",14890,10898,3992,9.20315650541707,1617923154
"1141","Louisiana Lafayette Parish",221578,18432,203146,318.368157740395,695980407
"1142","Louisiana Lafourche Parish",96318,23325,72993,34.8137909689903,2766662214
"1143","Louisiana Lincoln Parish",46735,19011,27724,38.250751201457,1221806070
"1144","Louisiana Livingston Parish",128026,52640,75386,76.2627375699525,1678749073
"1145","Louisiana Madison Parish",12093,2714,9379,7.47735343647598,1617283455
"1146","Louisiana Morehouse Parish",27979,14000,13979,13.589491384592,2058870285
"1147","Louisiana Natchitoches Parish",39566,19803,19763,12.1992582680777,3243311940
"1148","Louisiana Orleans Parish",343829,2035,341794,783.560507707209,438803381
"1149","Louisiana Ouachita Parish",153720,37187,116533,97.2330076868423,1580944616
"1150","Louisiana Plaquemines Parish",23042,4502,18540,11.4071506703699,2019961046
"1151","Louisiana Pointe Coupee Parish",22802,13182,9620,15.7961106919059,1443519892
"1152","Louisiana Rapides Parish",131613,52023,79590,38.5565412469865,3413506392
"1153","Louisiana Red River Parish",9091,9091,0,9.02118796722889,1007738674
"1154","Louisiana Richland Parish",20725,13688,7037,14.3136886450505,1447914686
"1155","Louisiana Sabine Parish",24233,21373,2860,10.795956250446,2244636736
"1156","Louisiana St. Bernard Parish",35897,1527,34370,36.713348245844,977764266
"1157","Louisiana St. Charles Parish",52780,6064,46716,73.0195037792359,722820579
"1158","Louisiana St. Helena Parish",11203,11203,0,10.5912667050513,1057758275
"1159","Louisiana St. James Parish",22102,6123,15979,35.3305392059231,625577772
"1160","Louisiana St. John the Baptist Parish",45924,6175,39749,83.2180016346129,551851752
"1161","Louisiana St. Landry Parish",83384,40168,43216,34.8473429237441,2392836670
"1162","Louisiana St. Martin Parish",52160,25856,26304,27.3017752176403,1910498478
"1163","Louisiana St. Mary Parish",54650,7126,47524,37.9929553719375,1438424557
"1164","Louisiana St. Tammany Parish",233740,54270,179470,106.732212866563,2189966775
"1165","Louisiana Tangipahoa Parish",121097,49564,71533,59.0892400169548,2049391733
"1166","Louisiana Tensas Parish",5252,5252,0,3.36406909424618,1561204557
"1167","Louisiana Terrebonne Parish",111860,23075,88785,35.0615896315534,3190385866
"1168","Louisiana Union Parish",22721,18838,3883,10.0031282173864,2271389460
"1169","Louisiana Vermilion Parish",57999,31680,26319,19.0875817924921,3038572441
"1170","Louisiana Vernon Parish",52334,26113,26221,15.2165951403877,3439271369
"1171","Louisiana Washington Parish",47168,31449,15719,27.2008862755529,1734061145
"1172","Louisiana Webster Parish",41207,21857,19350,26.8285261745272,1535939758
"1173","Louisiana West Baton Rouge Parish",23788,7246,16542,47.7384156376825,498298900
"1174","Louisiana West Carroll Parish",11604,11604,0,12.4576124609757,931478647
"1175","Louisiana West Feliciana Parish",15625,15625,0,14.961912930505,1044318335
"1176","Louisiana Winn Parish",15313,9937,5376,6.22299544628275,2460712069
"1177","Maine Androscoggin County",107702,46707,60995,88.8684300747399,1211926439
"1178","Maine Aroostook County",71870,57687,14183,4.15946494911588,17278664655
"1179","Maine Cumberland County",281674,101680,179994,130.207909049099,2163263369
"1180","Maine Franklin County",30768,25537,5231,7.00196278366252,4394196449
"1181","Maine Hancock County",54418,49038,5380,13.2402795708219,4110034060
"1182","Maine Kennebec County",122151,76748,45403,54.364793793386,2246876912
"1183","Maine Knox County",39736,26993,12743,42.0179347489072,945691411
"1184","Maine Lincoln County",34457,34457,0,29.1869045270492,1180563700
"1185","Maine Oxford County",57833,48066,9767,10.7516447197584,5378990983
"1186","Maine Penobscot County",153923,88737,65186,17.4929876659298,8799125852
"1187","Maine Piscataquis County",17535,17535,0,1.70930244247854,10258570727
"1188","Maine Sagadahoc County",35293,21767,13526,53.7129528783583,657066836
"1189","Maine Somerset County",52228,42031,10197,5.13844878629871,10164156961
"1190","Maine Waldo County",38786,35428,3358,20.5164857987812,1890479704
"1191","Maine Washington County",32856,30352,2504,4.95023731974228,6637257545
"1192","Maine York County",197131,112056,85075,76.8261838606137,2565935077
"1193","Maryland Allegany County",75087,20463,54624,68.3501602952671,1098563627
"1194","Maryland Anne Arundel County",537656,28518,509138,500.335623605685,1074590684
"1195","Maryland Baltimore city",620961,0,620961,2961.98912513473,209643241
"1196","Maryland Baltimore County",805029,52599,752430,519.509390708081,1549594703
"1197","Maryland Calvert County",88737,34350,54387,160.737649394656,552061078
"1198","Maryland Caroline County",33066,25130,7936,39.9689388667138,827292416
"1199","Maryland Carroll County",167134,66028,101106,144.172404365458,1159264845
"1200","Maryland Cecil County",101108,42569,58539,112.737686359508,896842957
"1201","Maryland Charles County",146551,43238,103313,123.612903463722,1185563933
"1202","Maryland Dorchester County",32618,18338,14280,23.2890010464814,1400575316
"1203","Maryland Frederick County",233385,58831,174554,136.485279470053,1709964627
"1204","Maryland Garrett County",30097,25251,4846,17.9577548462261,1675989023
"1205","Maryland Harford County",244826,43474,201352,216.266796874191,1132055422
"1206","Maryland Howard County",287085,26560,260525,442.066138831828,649416399
"1207","Maryland Kent County",20197,14660,5537,28.1489221282668,717505271
"1208","Maryland Montgomery County",971777,23165,948612,763.769573867221,1272343169
"1209","Maryland Prince George's County",863420,16981,846439,690.645618246781,1250163582
"1210","Maryland Queen Anne's County",47798,26044,21754,49.6223154503051,963235987
"1211","Maryland Somerset County",26470,12121,14349,31.9655317325758,828079452
"1212","Maryland St. Mary's County",105151,53015,52136,113.665446614733,925092041
"1213","Maryland Talbot County",37782,20650,17132,54.3226366839644,695511159
"1214","Maryland Washington County",147430,43477,103953,124.345908618179,1185644157
"1215","Maryland Wicomico County",98733,25479,73254,101.807139785146,969804281
"1216","Maryland Worcester County",51454,18280,33174,42.4243569712205,1212841011
"1217","Massachusetts Barnstable County",215888,16155,199733,211.709198728401,1019738402
"1218","Massachusetts Berkshire County",131219,41457,89762,54.66398227892,2400465435
"1219","Massachusetts Bristol County",548285,53920,494365,382.744020211503,1432510950
"1220","Massachusetts Dukes County",16535,6453,10082,61.8353230994172,267403794
"1221","Massachusetts Essex County",743159,31540,711619,582.535297533231,1275732137
"1222","Massachusetts Franklin County",71372,38849,32523,39.4052911629728,1811228845
"1223","Massachusetts Hampden County",463490,39725,423765,289.973779898769,1598385896
"1224","Massachusetts Hampshire County",158080,43383,114697,115.75989800768,1365585170
"1225","Massachusetts Middlesex County",1503085,45509,1457576,709.626616355515,2118135038
"1226","Massachusetts Nantucket County",10172,1922,8250,87.3347463383242,116471398
"1227","Massachusetts Norfolk County",670850,8321,662529,653.908291573318,1025908386
"1228","Massachusetts Plymouth County",494919,51015,443904,289.935546545166,1706996627
"1229","Massachusetts Suffolk County",722023,535,721488,4793.70801912806,150618894
"1230","Massachusetts Worcester County",798552,146856,651696,204.083091311553,3912876833
"1231","Michigan Alcona County",10942,10824,118,6.26270575692072,1747168145
"1232","Michigan Alger County",9601,6629,2972,4.05102230398029,2370019042
"1233","Michigan Allegan County",111408,71822,39586,52.1246541565831,2137337922
"1234","Michigan Alpena County",29598,15340,14258,19.9836532663018,1481110566
"1235","Michigan Antrim County",23580,23580,0,19.138615896175,1232064018
"1236","Michigan Arenac County",15899,15899,0,16.9019494069959,940660726
"1237","Michigan Baraga County",8860,8860,0,3.80833697239775,2326474801
"1238","Michigan Barry County",59173,45639,13534,41.3074927709514,1432500402
"1239","Michigan Bay County",107771,32667,75104,94.0773175234113,1145557748
"1240","Michigan Benzie County",17525,17525,0,21.164735834285,828028289
"1241","Michigan Berrien County",156813,51524,105289,106.642293378613,1470457874
"1242","Michigan Branch County",45248,28372,16876,34.5012492417558,1311488743
"1243","Michigan Calhoun County",136146,42174,93972,74.4318914783744,1829135298
"1244","Michigan Cass County",52293,37223,15070,41.1998020852679,1269253670
"1245","Michigan Charlevoix County",25949,18269,7680,24.0644335897353,1078313350
"1246","Michigan Cheboygan County",26152,21635,4517,14.1169448085805,1852525483
"1247","Michigan Chippewa County",38520,18851,19669,9.54341807436353,4036289692
"1248","Michigan Clare County",30926,21847,9079,21.1594398612269,1461569881
"1249","Michigan Clinton County",75382,39897,35485,51.3854522219627,1466991079
"1250","Michigan Crawford County",14074,10216,3858,9.76846810084358,1440758147
"1251","Michigan Delta County",37069,16219,20850,12.2213917045464,3033124287
"1252","Michigan Dickinson County",26168,8574,17594,13.2696556459857,1972018016
"1253","Michigan Eaton County",107759,40918,66841,72.3362589828903,1489695507
"1254","Michigan Emmet County",32694,24484,8210,27.0019017658937,1210803605
"1255","Michigan Genesee County",425790,71342,354448,258.091510102718,1649763682
"1256","Michigan Gladwin County",25692,22758,2934,19.7691389166273,1299601369
"1257","Michigan Gogebic County",16427,11198,5229,5.75623458531836,2853775286
"1258","Michigan Grand Traverse County",86986,41774,45212,72.3308984422656,1202611911
"1259","Michigan Gratiot County",42476,25552,16924,28.8498269760222,1472313856
"1260","Michigan Hillsdale County",46688,32274,14414,30.1376536685801,1549158422
"1261","Michigan Houghton County",36628,13851,22777,14.0146290068036,2613554735
"1262","Michigan Huron County",33118,29628,3490,15.3007460411473,2164469622
"1263","Michigan Ingham County",280895,37096,243799,195.019388590934,1440343968
"1264","Michigan Ionia County",63905,38687,25218,43.1886477701628,1479671240
"1265","Michigan Iosco County",25887,15249,10638,18.2026808625986,1422153154
"1266","Michigan Iron County",11817,8609,3208,3.912509329205,3020312287
"1267","Michigan Isabella County",70311,32757,37554,47.4041174006444,1483225590
"1268","Michigan Jackson County",160248,67021,93227,88.1788698933238,1817306121
"1269","Michigan Kalamazoo County",250331,43926,206405,172.085612454366,1454688724
"1270","Michigan Kalkaska County",17153,14485,2668,11.8293022105102,1450043265
"1271","Michigan Kent County",602622,94463,508159,274.720184707778,2193584722
"1272","Michigan Keweenaw County",2156,2156,0,1.54122946075841,1398883200
"1273","Michigan Lake County",11539,11539,0,7.85243013185284,1469481397
"1274","Michigan Lapeer County",88319,68313,20006,53.0317914412177,1665397257
"1275","Michigan Leelanau County",21708,19811,1897,24.1423028471437,899168573
"1276","Michigan Lenawee County",99892,51766,48126,51.4552396280662,1941337767
"1277","Michigan Livingston County",180967,66786,114181,123.611251999749,1464001028
"1278","Michigan Luce County",6631,3406,3225,2.8476310394195,2328602234
"1279","Michigan Mackinac County",11113,8582,2531,4.20016089628496,2645851022
"1280","Michigan Macomb County",840978,23592,817386,677.561597531718,1241183094
"1281","Michigan Manistee County",24733,15127,9606,17.6140907415996,1404159906
"1282","Michigan Marquette County",67077,27830,39247,14.321255603895,4683737366
"1283","Michigan Mason County",28705,17995,10710,22.3867291750211,1282232870
"1284","Michigan Mecosta County",42798,28557,14241,29.7698947400711,1437626850
"1285","Michigan Menominee County",24029,15459,8570,8.88596219371033,2704152851
"1286","Michigan Midland County",83629,35777,47852,62.5456272366266,1337087878
"1287","Michigan Missaukee County",14849,14849,0,10.1522317059766,1462634072
"1288","Michigan Monroe County",152021,57093,94928,106.837028697508,1422924260
"1289","Michigan Montcalm County",63342,53599,9743,34.6704050977062,1826976057
"1290","Michigan Montmorency County",9765,9765,0,6.89690974434601,1415851499
"1291","Michigan Muskegon County",172188,40145,132043,133.165168702624,1293040828
"1292","Michigan Newaygo County",48460,40629,7831,23.0083893325924,2106188282
"1293","Michigan Oakland County",1202362,57553,1144809,535.040044692172,2247237402
"1294","Michigan Oceana County",26570,23884,2686,20.0338121286252,1326257820
"1295","Michigan Ogemaw County",21699,21699,0,14.8681750557594,1459425916
"1296","Michigan Ontonagon County",6780,6780,0,1.99643336119969,3396056253
"1297","Michigan Osceola County",23528,23528,0,16.0387558839314,1466946699
"1298","Michigan Oscoda County",8640,8640,0,5.89665749034834,1465236876
"1299","Michigan Otsego County",24164,15866,8298,18.1170677473368,1333769920
"1300","Michigan Ottawa County",263801,53593,210208,180.763163216324,1459373665
"1301","Michigan Presque Isle County",13376,10816,2560,7.84022138065485,1706074274
"1302","Michigan Roscommon County",24449,16149,8300,18.166214754366,1345849993
"1303","Michigan Saginaw County",200169,62289,137880,96.5933907146108,2072284641
"1304","Michigan Sanilac County",43114,38888,4226,17.2937801602384,2493035045
"1305","Michigan Schoolcraft County",8485,5003,3482,2.79681836355774,3033804451
"1306","Michigan Shiawassee County",70648,38839,31809,51.4019365992472,1374422924
"1307","Michigan St. Clair County",163040,63008,100032,87.2887936438802,1867822812
"1308","Michigan St. Joseph County",61295,33361,27934,47.2763873119145,1296524618
"1309","Michigan Tuscola County",55729,46902,8827,26.7916523151519,2080088206
"1310","Michigan Van Buren County",76258,54036,22222,48.4685207184513,1573351092
"1311","Michigan Washtenaw County",344791,56706,288085,188.570920666741,1828442046
"1312","Michigan Wayne County",1820584,12664,1807920,1148.43043583565,1585280173
"1313","Michigan Wexford County",32735,21045,11690,22.3699374151132,1463347858
"1314","Minnesota Aitkin County",16202,16202,0,3.43402105472449,4718084060
"1315","Minnesota Anoka County",330844,44666,286178,301.977915918459,1095590050
"1316","Minnesota Becker County",32504,24531,7973,9.54215131895593,3406359731
"1317","Minnesota Beltrami County",44442,29816,14626,6.85012540313501,6487764440
"1318","Minnesota Benton County",38451,15385,23066,36.3604803955634,1057494279
"1319","Minnesota Big Stone County",5269,5269,0,4.07671603382544,1292461863
"1320","Minnesota Blue Earth County",64013,17215,46798,33.0490982671019,1936906099
"1321","Minnesota Brown County",25893,9047,16846,16.3598522114905,1582716009
"1322","Minnesota Carlton County",35386,19521,15865,15.8612801643882,2230967465
"1323","Minnesota Carver County",91042,17141,73901,99.2069402081541,917697893
"1324","Minnesota Cass County",28567,28567,0,5.45612163034248,5235770376
"1325","Minnesota Chippewa County",12441,6263,6178,8.26590788223501,1505097828
"1326","Minnesota Chisago County",53887,29955,23932,50.1513867450346,1074486739
"1327","Minnesota Clay County",58999,16472,42527,21.7910669026135,2707485607
"1328","Minnesota Clearwater County",8695,8695,0,3.3607213181679,2587242195
"1329","Minnesota Cook County",5176,5176,0,1.37609042305058,3761380730
"1330","Minnesota Cottonwood County",11687,7278,4409,7.06593114364188,1653992908
"1331","Minnesota Crow Wing County",62500,39210,23290,24.1532560095684,2587642841
"1332","Minnesota Dakota County",398552,19652,378900,273.729394567766,1456007312
"1333","Minnesota Dodge County",20087,10398,9689,17.6554898099289,1137719781
"1334","Minnesota Douglas County",36009,19026,16983,21.8157259417449,1650598293
"1335","Minnesota Faribault County",14553,11296,3257,7.8865046477668,1845304181
"1336","Minnesota Fillmore County",20866,19464,1402,9.35377631555313,2230756787
"1337","Minnesota Freeborn County",31255,13387,17868,17.066680899403,1831346129
"1338","Minnesota Goodhue County",46183,21726,24457,23.5603440614436,1960200576
"1339","Minnesota Grant County",6018,6018,0,4.23883878424452,1419728446
"1340","Minnesota Hennepin County",1152425,25641,1126784,803.759214959822,1433793826
"1341","Minnesota Houston County",19027,10920,8107,13.307226858017,1429824576
"1342","Minnesota Hubbard County",20428,17030,3398,8.52059224621259,2397485927
"1343","Minnesota Isanti County",37816,23546,14270,33.5039913507961,1128701342
"1344","Minnesota Itasca County",45058,35773,9285,6.52129181174068,6909367239
"1345","Minnesota Jackson County",10266,7097,3169,5.63844742110871,1820713972
"1346","Minnesota Kanabec County",16239,12569,3670,12.0208508397754,1350902712
"1347","Minnesota Kandiyohi County",42239,18807,23432,20.4679802512983,2063662339
"1348","Minnesota Kittson County",4552,4552,0,1.59949993841117,2845889450
"1349","Minnesota Koochiching County",13311,6256,7055,1.65569924158571,8039503592
"1350","Minnesota Lac qui Parle County",7259,7259,0,3.66358113023578,1981394636
"1351","Minnesota Lake County",10866,7278,3588,1.98900217654773,5463040779
"1352","Minnesota Lake of the Woods County",4045,4045,0,1.20334391692901,3361466280
"1353","Minnesota Le Sueur County",27703,17220,10483,23.8349599882622,1162284309
"1354","Minnesota Lincoln County",5896,5896,0,4.24113792130095,1390192941
"1355","Minnesota Lyon County",25857,12393,13464,13.9714785587218,1850698900
"1356","Minnesota Mahnomen County",5413,5413,0,3.74628988485917,1444896195
"1357","Minnesota Marshall County",9439,9439,0,2.05311474937966,4597404993
"1358","Minnesota Martin County",20840,11262,9578,11.2955697525546,1844971122
"1359","Minnesota McLeod County",36651,17063,19588,28.7932184944778,1272903896
"1360","Minnesota Meeker County",23300,15266,8034,14.7920073969331,1575174983
"1361","Minnesota Mille Lacs County",26097,18483,7614,17.6060320650026,1482276069
"1362","Minnesota Morrison County",33198,24174,9024,11.3929895473971,2913897170
"1363","Minnesota Mower County",39163,14060,25103,21.2572907430804,1842332613
"1364","Minnesota Murray County",8725,8725,0,4.78037785606709,1825169529
"1365","Minnesota Nicollet County",32727,8369,24358,28.1742359559057,1161593168
"1366","Minnesota Nobles County",21378,8762,12616,11.5424704406176,1852116504
"1367","Minnesota Norman County",6852,6852,0,3.03117139342455,2260512228
"1368","Minnesota Olmsted County",144248,23935,120313,85.244620959995,1692165422
"1369","Minnesota Otter Tail County",57303,42169,15134,11.219091357057,5107632889
"1370","Minnesota Pennington County",13930,5047,8883,8.72310018910585,1596909321
"1371","Minnesota Pine County",29750,26567,3183,8.13904284239521,3655220961
"1372","Minnesota Pipestone County",9596,5498,4098,7.9668829924468,1204486122
"1373","Minnesota Polk County",31600,15318,16282,6.18976845761149,5105199042
"1374","Minnesota Pope County",10995,10995,0,6.33882191331485,1734549440
"1375","Minnesota Ramsey County",508640,952,507688,1290.21691401523,394228284
"1376","Minnesota Red Lake County",4089,4089,0,3.65112311587415,1119929367
"1377","Minnesota Redwood County",16059,11101,4958,7.05737536569632,2275491832
"1378","Minnesota Renville County",15730,15730,0,6.17900967989751,2545715384
"1379","Minnesota Rice County",64142,16635,47507,49.9620316367308,1283814887
"1380","Minnesota Rock County",9687,5067,4620,7.7523745314315,1249552632
"1381","Minnesota Roseau County",15629,12866,2763,3.60994496223954,4329428887
"1382","Minnesota Scott County",129928,22399,107529,140.726145698724,923268376
"1383","Minnesota Sherburne County",88499,39110,49389,78.9287985626113,1121251072
"1384","Minnesota Sibley County",15226,15226,0,9.98471253687018,1524931233
"1385","Minnesota St. Louis County",200226,74313,125913,12.3743777560081,16180692391
"1386","Minnesota Stearns County",150642,55637,95005,43.3041365249738,3478697697
"1387","Minnesota Steele County",36576,11182,25394,32.8691613323671,1112775578
"1388","Minnesota Stevens County",9726,4603,5123,6.6628919047972,1459726518
"1389","Minnesota Swift County",9783,6592,3191,5.09004893341929,1921985452
"1390","Minnesota Todd County",24895,19515,5380,10.1716408561794,2447491054
"1391","Minnesota Traverse County",3558,3558,0,2.39370374698154,1486399478
"1392","Minnesota Wabasha County",21676,13990,7686,16.0027367721552,1354518312
"1393","Minnesota Wadena County",13843,9273,4570,9.96667270069273,1388928925
"1394","Minnesota Waseca County",19136,9599,9537,17.452086991945,1096487773
"1395","Minnesota Washington County",238136,34454,203682,239.264002483259,995285532
"1396","Minnesota Watonwan County",11211,6626,4585,9.95198785031923,1126508610
"1397","Minnesota Wilkin County",6576,3297,3279,3.38102805373477,1944970552
"1398","Minnesota Winona County",51461,17772,33689,31.7295260932278,1621864753
"1399","Minnesota Wright County",124700,40537,84163,72.7892627527673,1713164762
"1400","Minnesota Yellow Medicine County",10438,8436,2002,5.30908791394005,1966062753
"1401","Mississippi Adams County",32297,12023,20274,26.9674678218708,1197628202
"1402","Mississippi Alcorn County",37057,24588,12469,35.7661057135303,1036092671
"1403","Mississippi Amite County",13131,13131,0,6.94412500640908,1890950982
"1404","Mississippi Attala County",19564,12581,6983,10.2773990350832,1903594473
"1405","Mississippi Benton County",8729,8729,0,8.28861457698848,1053131367
"1406","Mississippi Bolivar County",34145,18423,15722,15.0397660797107,2270314566
"1407","Mississippi Calhoun County",14962,14962,0,9.84848725702048,1519218090
"1408","Mississippi Carroll County",10597,10597,0,6.51265076264895,1627140835
"1409","Mississippi Chickasaw County",17392,14835,2557,13.3825569817861,1299602163
"1410","Mississippi Choctaw County",8547,8547,0,7.89142406511402,1083074478
"1411","Mississippi Claiborne County",9604,9604,0,7.60788097411596,1262375165
"1412","Mississippi Clarke County",16732,16732,0,9.34165277152579,1791117740
"1413","Mississippi Clay County",20634,11461,9173,19.4276634635285,1062093753
"1414","Mississippi Coahoma County",26151,8368,17783,18.2769547056463,1430818231
"1415","Mississippi Copiah County",29449,19312,10137,14.6290238949847,2013052970
"1416","Mississippi Covington County",19568,19568,0,18.2585549401057,1071716796
"1417","Mississippi DeSoto County",161252,32942,128310,130.757875344142,1233210616
"1418","Mississippi Forrest County",74934,22207,52727,62.0443979872196,1207748039
"1419","Mississippi Franklin County",8118,8118,0,5.55958345710563,1460181336
"1420","Mississippi George County",22578,19942,2636,18.2102786216667,1239849234
"1421","Mississippi Greene County",14400,14400,0,7.80053244191795,1846027833
"1422","Mississippi Grenada County",21906,11425,10481,20.0374770887786,1093251406
"1423","Mississippi Hancock County",43929,18696,25233,35.8018814686184,1227002554
"1424","Mississippi Harrison County",187105,42744,144361,125.857854244536,1486637454
"1425","Mississippi Hinds County",245285,37471,207814,108.888815797666,2252618859
"1426","Mississippi Holmes County",19198,16673,2525,9.79569286466623,1959840949
"1427","Mississippi Humphreys County",9375,4673,4702,8.64942759508988,1083886754
"1428","Mississippi Issaquena County",1406,1406,0,1.31428658127151,1069781903
"1429","Mississippi Itawamba County",23401,20184,3217,16.958331992698,1379911657
"1430","Mississippi Jackson County",139668,38074,101594,74.6120218933857,1871923538
"1431","Mississippi Jasper County",17062,17062,0,9.74158136229874,1751461017
"1432","Mississippi Jefferson County",7726,7726,0,5.73732508134298,1346620575
"1433","Mississippi Jefferson Davis County",12487,12487,0,11.8039942287042,1057862259
"1434","Mississippi Jones County",67761,41630,26131,37.6552332489465,1799510829
"1435","Mississippi Kemper County",10456,10456,0,5.26909052561129,1984403181
"1436","Mississippi Lafayette County",47351,21583,25768,28.9410941217824,1636116444
"1437","Mississippi Lamar County",55658,28027,27631,43.2339592827593,1287367637
"1438","Mississippi Lauderdale County",80261,38730,41531,44.0413043881706,1822402881
"1439","Mississippi Lawrence County",12929,12929,0,11.5911049937379,1115424285
"1440","Mississippi Leake County",23805,19327,4478,15.7652769199004,1509963962
"1441","Mississippi Lee County",82910,37612,45298,71.1449329692753,1165367603
"1442","Mississippi Leflore County",32317,5714,26603,21.0579722431113,1534668183
"1443","Mississippi Lincoln County",34869,24234,10635,22.9698896149673,1518030804
"1444","Mississippi Lowndes County",59779,25465,34314,45.6585141033066,1309262931
"1445","Mississippi Madison County",95203,26639,68564,51.4454353840387,1850562626
"1446","Mississippi Marion County",27088,19794,7294,19.2829151547227,1404766851
"1447","Mississippi Marshall County",37144,30984,6160,20.3080294171451,1829030244
"1448","Mississippi Monroe County",36989,25757,11232,18.6663738949197,1981584651
"1449","Mississippi Montgomery County",10925,6537,4388,10.364538080088,1054074954
"1450","Mississippi Neshoba County",29676,21917,7759,20.0967368849899,1476657637
"1451","Mississippi Newton County",21720,18910,2810,14.5062786653701,1497282694
"1452","Mississippi Noxubee County",11545,8547,2998,6.41246338759039,1800400143
"1453","Mississippi Oktibbeha County",47671,17364,30307,40.1699152275667,1186733896
"1454","Mississippi Panola County",34707,27398,7309,19.5585778926062,1774515519
"1455","Mississippi Pearl River County",55834,39042,16792,26.5860283928803,2100125644
"1456","Mississippi Perry County",12250,12250,0,7.30743954439092,1676373773
"1457","Mississippi Pike County",40404,24016,16388,38.1406244692022,1059342907
"1458","Mississippi Pontotoc County",29957,25150,4807,23.2403337364368,1289009028
"1459","Mississippi Prentiss County",25276,19226,6050,23.5170714483819,1074793690
"1460","Mississippi Quitman County",8223,4687,3536,7.83906525441545,1048977108
"1461","Mississippi Rankin County",141617,48018,93599,70.5089496373428,2008496804
"1462","Mississippi Scott County",28264,20398,7866,17.9137620202007,1577781371
"1463","Mississippi Sharkey County",4916,4916,0,4.39654933981081,1118149626
"1464","Mississippi Simpson County",27503,23333,4170,18.0238117772268,1525925833
"1465","Mississippi Smith County",16491,16491,0,10.0073715326694,1647885256
"1466","Mississippi Stone County",17786,14018,3768,15.4151484563343,1153800111
"1467","Mississippi Sunflower County",29450,13477,15973,16.2961481822112,1807175516
"1468","Mississippi Tallahatchie County",15378,12448,2930,9.20129107672218,1671287200
"1469","Mississippi Tate County",28886,22355,6531,27.5545625983906,1048320034
"1470","Mississippi Tippah County",22232,18640,3592,18.7495550016779,1185734808
"1471","Mississippi Tishomingo County",19593,19593,0,17.8310448463346,1098813904
"1472","Mississippi Tunica County",10778,7116,3662,9.15263743824523,1177584065
"1473","Mississippi Union County",27134,20502,6632,25.2082337932561,1076394333
"1474","Mississippi Walthall County",15443,15443,0,14.76089437688,1046210318
"1475","Mississippi Warren County",48773,19945,28828,31.998869090304,1524210117
"1476","Mississippi Washington County",51137,8961,42176,27.2429738452838,1877071141
"1477","Mississippi Wayne County",20747,16523,4224,9.88031144442761,2099832593
"1478","Mississippi Webster County",10253,10253,0,9.40443323955607,1090230505
"1479","Mississippi Wilkinson County",9878,9878,0,5.6243648885376,1756287189
"1480","Mississippi Winston County",19198,14574,4624,12.2065888805319,1572757155
"1481","Mississippi Yalobusha County",12678,10056,2622,10.4789128405812,1209858331
"1482","Mississippi Yazoo County",28065,12519,15546,11.7406089815936,2390421148
"1483","Missouri Adair County",25607,9693,15914,17.4273020455869,1469361117
"1484","Missouri Andrew County",17291,10596,6695,15.4288206377347,1120694861
"1485","Missouri Atchison County",5685,5685,0,4.01056714248301,1417505255
"1486","Missouri Audrain County",25529,10517,15012,14.2391042488908,1792879633
"1487","Missouri Barry County",35597,26080,9517,17.6602162418838,2015660483
"1488","Missouri Barton County",12402,7932,4470,8.08966234729097,1533067694
"1489","Missouri Bates County",17049,13174,3875,7.86750629145429,2167014473
"1490","Missouri Benton County",19056,16491,2565,10.4501875596713,1823507941
"1491","Missouri Bollinger County",12363,12363,0,7.72509597799086,1600368466
"1492","Missouri Boone County",162642,30554,132088,91.6183051911412,1775212930
"1493","Missouri Buchanan County",89201,11928,77273,84.4079451422336,1056784404
"1494","Missouri Butler County",42794,22331,20463,23.7852122346612,1799185123
"1495","Missouri Caldwell County",9424,9424,0,8.53350953219501,1104352197
"1496","Missouri Callaway County",44332,27498,16834,20.5094648214671,2161538606
"1497","Missouri Camden County",44002,32662,11340,25.9013276156884,1698831838
"1498","Missouri Cape Girardeau County",75674,23083,52591,50.5032641193131,1498398199
"1499","Missouri Carroll County",9295,5999,3296,5.1665833080092,1799061284
"1500","Missouri Carter County",6265,6265,0,4.76767164606276,1314058615
"1501","Missouri Cass County",99478,32233,67245,55.1186590622605,1804797172
"1502","Missouri Cedar County",13982,10528,3454,11.3775990686598,1228906021
"1503","Missouri Chariton County",7831,7831,0,4.02508166495437,1945550588
"1504","Missouri Christian County",77422,34682,42740,53.12906362375,1457243827
"1505","Missouri Clark County",7139,7139,0,5.46151286609989,1307146971
"1506","Missouri Clay County",221939,21785,200154,215.684572930673,1028998027
"1507","Missouri Clinton County",20743,15808,4935,19.1163879100015,1085089929
"1508","Missouri Cole County",75990,22094,53896,74.5139997194885,1019808362
"1509","Missouri Cooper County",17601,9364,8237,12.0329316995825,1462735802
"1510","Missouri Crawford County",24696,18104,6592,12.8417049389401,1923109129
"1511","Missouri Dade County",7883,7883,0,6.21136673004338,1269124871
"1512","Missouri Dallas County",16777,13746,3031,11.9785530479964,1400586526
"1513","Missouri Daviess County",8433,8433,0,5.78084010898967,1458784509
"1514","Missouri DeKalb County",12892,8045,4847,11.813354107243,1091307336
"1515","Missouri Dent County",15657,10736,4921,8.03039489233772,1949717319
"1516","Missouri Douglas County",13684,10827,2857,6.49362882358137,2107296301
"1517","Missouri Dunklin County",31953,16122,15831,22.8013912286734,1401361859
"1518","Missouri Franklin County",101492,56428,45064,42.4700174489957,2389732948
"1519","Missouri Gasconade County",15222,12310,2912,11.3503535361844,1341103601
"1520","Missouri Gentry County",6738,6738,0,5.29393701374623,1272776760
"1521","Missouri Greene County",275174,38518,236656,157.3294539634,1749030414
"1522","Missouri Grundy County",10261,4665,5596,9.10178931393999,1127360747
"1523","Missouri Harrison County",8957,6305,2652,4.78657292047015,1871276203
"1524","Missouri Henry County",22272,11035,11237,12.3384770807426,1805085008
"1525","Missouri Hickory County",9627,9627,0,9.31367371057349,1033641536
"1526","Missouri Holt County",4912,4912,0,4.09890238904225,1198369596
"1527","Missouri Howard County",10144,6498,3646,8.44374385084292,1201362829
"1528","Missouri Howell County",40400,29158,11242,16.8223835177338,2401562178
"1529","Missouri Iron County",10630,7957,2673,7.4587841969573,1425165244
"1530","Missouri Jackson County",674158,25867,648291,430.620570143658,1565549922
"1531","Missouri Jasper County",117404,27815,89589,70.9958153625755,1653674930
"1532","Missouri Jefferson County",218733,66049,152684,128.616467380674,1700660922
"1533","Missouri Johnson County",52595,26531,26064,24.4875090156995,2147829735
"1534","Missouri Knox County",4131,4131,0,3.16459177652031,1305381639
"1535","Missouri Laclede County",35571,21525,14046,17.9596291559491,1980608825
"1536","Missouri Lafayette County",33381,19010,14371,20.5089025289976,1627634631
"1537","Missouri Lawrence County",38634,22673,15961,24.3841395624391,1584390538
"1538","Missouri Lewis County",10211,10211,0,7.80626022622192,1308052730
"1539","Missouri Lincoln County",52566,39335,13231,32.3927171107676,1622772175
"1540","Missouri Linn County",12761,8480,4281,8.00412355685977,1594303225
"1541","Missouri Livingston County",15195,5562,9633,11.0210409477982,1378726390
"1542","Missouri Macon County",15566,10552,5014,7.50108253569345,2075167141
"1543","Missouri Madison County",12226,8009,4217,9.54810560836449,1280463424
"1544","Missouri Maries County",9176,9176,0,6.72298786742911,1364869338
"1545","Missouri Marion County",28781,7128,21653,25.4332804682349,1131627516
"1546","Missouri McDonald County",23083,23081,2,16.5203408176012,1397247203
"1547","Missouri Mercer County",3785,3785,0,3.22010475714558,1175427598
"1548","Missouri Miller County",24748,19744,5004,16.1244378563448,1534813196
"1549","Missouri Mississippi County",14358,4695,9663,13.469100768386,1065995440
"1550","Missouri Moniteau County",15607,8225,7382,14.5193449376536,1074910753
"1551","Missouri Monroe County",8840,8840,0,5.27001674497147,1677414025
"1552","Missouri Montgomery County",12236,9607,2629,8.81001170305942,1388874432
"1553","Missouri Morgan County",20565,20565,0,13.2861209179872,1547855851
"1554","Missouri New Madrid County",18956,10779,8177,10.8454587122721,1747828331
"1555","Missouri Newton County",58114,37447,20667,35.9142245090305,1618133227
"1556","Missouri Nodaway County",23370,10150,13220,10.2891420942512,2271326393
"1557","Missouri Oregon County",10881,8763,2118,5.31932265169901,2045561195
"1558","Missouri Osage County",13878,13878,0,8.8663257983713,1565248144
"1559","Missouri Ozark County",9723,9723,0,5.03921425523859,1929467474
"1560","Missouri Pemiscot County",18296,9014,9282,14.3421315223818,1275682068
"1561","Missouri Perry County",18971,10552,8419,15.4415263530183,1228570257
"1562","Missouri Pettis County",42201,15943,26258,23.8835681908258,1766947035
"1563","Missouri Phelps County",45156,20873,24283,25.9530374212867,1739911952
"1564","Missouri Pike County",18516,10069,8447,10.6632853447964,1736425445
"1565","Missouri Platte County",89322,14120,75202,82.0757866010399,1088286859
"1566","Missouri Polk County",31137,21444,9693,18.9168073533208,1645996569
"1567","Missouri Pulaski County",52274,23017,29257,36.8911547917844,1416979227
"1568","Missouri Putnam County",4979,4979,0,3.7161011565277,1339845120
"1569","Missouri Ralls County",10167,9771,396,8.35602847350851,1216726347
"1570","Missouri Randolph County",25414,11481,13933,20.3288314146681,1250145642
"1571","Missouri Ray County",23494,17672,5822,15.947609906235,1473198814
"1572","Missouri Reynolds County",6696,6696,0,3.19778841411744,2093947170
"1573","Missouri Ripley County",14100,14100,0,8.64769372313248,1630492528
"1574","Missouri Saline County",23370,10705,12665,11.9432964175768,1956746210
"1575","Missouri Schuyler County",4431,4431,0,5.56720165028693,795911533
"1576","Missouri Scotland County",4843,4843,0,4.28215921820954,1130971492
"1577","Missouri Scott County",39191,16285,22906,36.0287948644647,1087768829
"1578","Missouri Shannon County",8441,8441,0,3.2466868950684,2599881132
"1579","Missouri Shelby County",6373,6373,0,4.91277380137017,1297230497
"1580","Missouri St. Charles County",360485,21018,339467,248.349940152614,1451520382
"1581","Missouri St. Clair County",9805,9805,0,5.65048952645748,1735247885
"1582","Missouri St. Francois County",65359,25989,39370,55.844214486405,1170380864
"1583","Missouri St. Louis city",319294,1,319293,1991.31644980409,160343174
"1584","Missouri St. Louis County",998954,11368,987586,759.548064119289,1315195242
"1585","Missouri Ste. Genevieve County",18145,13816,4329,14.0354321479469,1292799524
"1586","Missouri Stoddard County",29968,20915,9053,14.0553960491771,2132134868
"1587","Missouri Stone County",32202,28559,3643,26.7938991634545,1201840755
"1588","Missouri Sullivan County",6714,6714,0,4.00056350624287,1678263572
"1589","Missouri Taney County",51675,22665,29010,31.5475631171408,1638002904
"1590","Missouri Texas County",26008,25803,205,8.52971750973067,3049104495
"1591","Missouri Vernon County",21159,12327,8832,9.88571939251835,2140360166
"1592","Missouri Warren County",32513,20496,12017,29.2890992582044,1110071693
"1593","Missouri Washington County",25195,20276,4919,12.8012661444512,1968164689
"1594","Missouri Wayne County",13521,13521,0,6.87651434045979,1966257806
"1595","Missouri Webster County",36202,26764,9438,23.588527604335,1534729111
"1596","Missouri Worth County",2171,2171,0,3.14399143339812,690523510
"1597","Missouri Wright County",18815,14417,4398,10.655348623129,1765779860
"1598","Montana Beaverhead County",9246,4637,4609,0.644197626043918,14352738393
"1599","Montana Big Horn County",12865,9251,3614,0.994343279243418,12938187715
"1600","Montana Blaine County",6491,6491,0,0.592823586268987,10949294445
"1601","Montana Broadwater County",5612,5612,0,1.81696461083134,3088667752
"1602","Montana Carbon County",10078,10078,0,1.89923883158673,5306336324
"1603","Montana Carter County",1160,1160,0,0.134065201075497,8652506323
"1604","Montana Cascade County",81327,16120,65207,11.6377664972489,6988196577
"1605","Montana Chouteau County",5813,5813,0,0.564988949046506,10288696814
"1606","Montana Custer County",11699,2095,9604,1.19391399131331,9798863306
"1607","Montana Daniels County",1751,1751,0,0.474063961608012,3693594413
"1608","Montana Dawson County",8966,2472,6494,1.45952354713305,6143100615
"1609","Montana Deer Lodge County",9298,3128,6170,4.87417441161212,1907605107
"1610","Montana Fallon County",2890,2890,0,0.688459036077865,4197780621
"1611","Montana Fergus County",11586,5496,6090,1.03077934783794,11240038932
"1612","Montana Flathead County",90928,46814,44114,6.90051934271768,13176979222
"1613","Montana Gallatin County",89513,30025,59488,13.2790194197541,6740934490
"1614","Montana Garfield County",1206,1206,0,0.0995943809900694,12109116880
"1615","Montana Glacier County",13399,5897,7502,1.72679958307395,7759441299
"1616","Montana Golden Valley County",884,884,0,0.290395676131899,3044122460
"1617","Montana Granite County",3079,3079,0,0.688200941725452,4473983997
"1618","Montana Hill County",16096,6439,9657,2.14377273970457,7508258549
"1619","Montana Jefferson County",11406,11406,0,2.65893524945075,4289687010
"1620","Montana Judith Basin County",2072,2072,0,0.427850438723219,4842813779
"1621","Montana Lake County",28746,23983,4763,7.44817303215432,3859469950
"1622","Montana Lewis and Clark County",63395,18340,45055,7.07665953813246,8958322731
"1623","Montana Liberty County",2339,2339,0,0.631513476809842,3703800609
"1624","Montana Lincoln County",19687,15709,3978,2.10389437682238,9357408916
"1625","Montana Madison County",7691,7691,0,0.827742114544827,9291541248
"1626","Montana McCone County",1734,1734,0,0.253294572522849,6845784269
"1627","Montana Meagher County",1891,1891,0,0.305244896700564,6195025766
"1628","Montana Mineral County",4223,4223,0,1.3371003438418,3158326912
"1629","Montana Missoula County",109299,24403,84896,16.272151243765,6716936093
"1630","Montana Musselshell County",4538,4538,0,0.937894071550162,4838499504
"1631","Montana Park County",15636,7464,8172,2.15374902310071,7259898824
"1632","Montana Petroleum County",494,494,0,0.115256382124544,4286096708
"1633","Montana Phillips County",4253,4253,0,0.319471074668772,13312629334
"1634","Montana Pondera County",6153,3575,2578,1.46388653200368,4203194623
"1635","Montana Powder River County",1743,1743,0,0.204099249993125,8539962788
"1636","Montana Powell County",7027,3810,3217,1.16624359015959,6025327864
"1637","Montana Prairie County",1179,1179,0,0.262109059502407,4498127620
"1638","Montana Ravalli County",40212,34030,6182,6.49397820564844,6192198176
"1639","Montana Richland County",9746,4308,5438,1.80551506343654,5397905671
"1640","Montana Roosevelt County",10425,4142,6283,1.70932841593297,6098886500
"1641","Montana Rosebud County",9233,9233,0,0.711496089497895,12976880880
"1642","Montana Sanders County",11413,11413,0,1.59628544575382,7149723773
"1643","Montana Sheridan County",3384,3384,0,0.779074262383182,4343616730
"1644","Montana Silver Bow County",34200,3913,30287,18.3787182524973,1860847940
"1645","Montana Stillwater County",9117,9117,0,1.96067233578725,4649935552
"1646","Montana Sweet Grass County",3651,3651,0,0.759840188297115,4804957748
"1647","Montana Teton County",6073,6073,0,1.03187142370831,5885423184
"1648","Montana Toole County",5324,2287,3037,1.07306178554601,4961503682
"1649","Montana Treasure County",718,718,0,0.283632114708058,2531448178
"1650","Montana Valley County",7369,4068,3301,0.577606928537342,12757810954
"1651","Montana Wheatland County",2168,2168,0,0.588162358059484,3686057039
"1652","Montana Wibaux County",1017,1017,0,0.441562531705557,2303184548
"1653","Montana Yellowstone County",147972,24694,123278,21.6961400650018,6820199333
"1654","NA Adjuntas Municipio",19483,8482,11001,112.797374838089,172725651
"1655","NA Aguada Municipio",41959,0,41959,525.116024497622,79904246
"1656","NA Aguadilla Municipio",60949,43,60906,644.222339056746,94608641
"1657","NA Aguas Buenas Municipio",28659,3021,25638,367.802819187626,77919468
"1658","NA Aibonito Municipio",25900,3110,22790,319.380653091509,81094455
"1659","NA Anasco Municipio",29261,3685,25576,287.583661650888,101747783
"1660","NA Arecibo Municipio",96440,9039,87401,295.646349381931,326200544
"1661","NA Arroyo Municipio",19575,826,18749,503.608940132796,38869445
"1662","NA Barceloneta Municipio",24816,508,24308,512.573871228827,48414485
"1663","NA Barranquitas Municipio",30318,966,29352,341.749657926267,88714061
"1664","NA Bayamon Municipio",208116,24,208092,1812.87977227102,114798567
"1665","NA Cabo Rojo Municipio",50917,2308,48609,279.354163152817,182266838
"1666","NA Caguas Municipio",142893,1281,141612,941.532451087167,151766410
"1667","NA Camuy Municipio",35159,4744,30415,292.849307737354,120058334
"1668","NA Canovanas Municipio",47648,1085,46563,559.773239206655,85120182
"1669","NA Carolina Municipio",176762,290,176472,1505.89794836931,117379800
"1670","NA Catano Municipio",28140,4,28136,2242.70677971694,12547338
"1671","NA Cayey Municipio",48119,4407,43712,357.737699765846,134509167
"1672","NA Ceiba Municipio",13631,1610,12021,181.26075491893,75201055
"1673","NA Ciales Municipio",18782,7221,11561,109.001237711318,172309970
"1674","NA Cidra Municipio",43480,1692,41788,466.050448932099,93294621
"1675","NA Coamo Municipio",40512,7643,32869,200.503911585733,202050921
"1676","NA Comerio Municipio",20778,2610,18168,282.474312381759,73557131
"1677","NA Corozal Municipio",37142,2371,34771,336.849078063608,110263030
"1678","NA Culebra Municipio",1818,1818,0,60.3872215988816,30105707
"1679","NA District of Columbia",601723,0,601723,3805.61121838908,158114680
"1680","NA Dorado Municipio",38165,9,38156,638.218290521815,59799289
"1681","NA Fajardo Municipio",36993,784,36209,478.27074426791,77347403
"1682","NA Florida Municipio",12680,2271,10409,321.896921294578,39391492
"1683","NA Guanica Municipio",19427,2187,17240,202.44920921163,95959871
"1684","NA Guayama Municipio",45362,4139,41223,269.486039649451,168327829
"1685","NA Guayanilla Municipio",21581,2614,18967,197.123865883538,109479387
"1686","NA Guaynabo Municipio",97924,13,97911,1370.94270665172,71428222
"1687","NA Gurabo Municipio",45369,162,45207,628.134494132635,72228162
"1688","NA Hatillo Municipio",41953,4546,37407,387.694773236262,108211415
"1689","NA Hormigueros Municipio",17250,34,17216,587.117838191958,29380814
"1690","NA Humacao Municipio",58466,282,58184,504.390851509778,115914077
"1691","NA Isabela Municipio",45631,2983,42648,318.572460266392,143235859
"1692","NA Jayuya Municipio",16642,5342,11300,144.286163453716,115340235
"1693","NA Juana Diaz Municipio",50747,3420,47327,325.057193270935,156117142
"1694","NA Juncos Municipio",40290,1295,38995,587.271050835765,68605459
"1695","NA Lajas Municipio",25753,4705,21048,165.852360962745,155276656
"1696","NA Lares Municipio",30753,7911,22842,193.226351082937,159155311
"1697","NA Las Marias Municipio",9881,6552,3329,82.2923913542636,120071854
"1698","NA Las Piedras Municipio",38675,941,37734,440.749349793567,87748286
"1699","NA Loiza Municipio",30060,221,29839,599.302799114898,50158284
"1700","NA Luquillo Municipio",20068,1779,18289,300.18793158653,66851455
"1701","NA Manati Municipio",44113,3056,41057,377.416956569655,116881341
"1702","NA Maricao Municipio",6276,3579,2697,66.1663341938401,94851862
"1703","NA Maunabo Municipio",12225,2948,9277,224.059076964944,54561503
"1704","NA Mayaguez Municipio",89080,3615,85465,442.962977166303,201100328
"1705","NA Moca Municipio",40109,5037,35072,307.608877256741,130389605
"1706","NA Morovis Municipio",32610,3608,29002,323.911125223743,100675764
"1707","NA Naguabo Municipio",26720,2239,24481,199.700580668302,133800312
"1708","NA Naranjito Municipio",30402,0,30402,428.383137581694,70969180
"1709","NA Orocovis Municipio",23423,8407,15016,142.152402086108,164773860
"1710","NA Patillas Municipio",19277,4932,14345,159.378678299417,120950934
"1711","NA Penuelas Municipio",24282,3974,20308,210.127038071961,115558665
"1712","NA Ponce Municipio",166327,7327,159000,559.585667802801,297232416
"1713","NA Quebradillas Municipio",25919,1957,23962,441.191259636707,58747764
"1714","NA Rincon Municipio",15200,0,15200,410.752661555642,37005238
"1715","NA Rio Grande Municipio",54304,1388,52916,345.859448309597,157011758
"1716","NA Sabana Grande Municipio",25265,2102,23163,272.233585790969,92806330
"1717","NA Salinas Municipio",31078,4256,26822,172.987229737372,179654880
"1718","NA San German Municipio",35527,3161,32366,251.699831114493,141148287
"1719","NA San Juan Municipio",395326,0,395326,3190.09356543152,123923011
"1720","NA San Lorenzo Municipio",41058,4607,36451,298.499632578927,137547908
"1721","NA San Sebastian Municipio",42430,5566,36864,232.627142644425,182394881
"1722","NA Santa Isabel Municipio",23274,2979,20295,264.117361799149,88119917
"1723","NA Toa Alta Municipio",74066,0,74066,1058.50613780213,69972197
"1724","NA Toa Baja Municipio",89609,0,89609,1488.6848554388,60193398
"1725","NA Trujillo Alto Municipio",74842,0,74842,1391.66044660284,53778923
"1726","NA Utuado Municipio",33149,15556,17593,112.736429495562,294039825
"1727","NA Vega Alta Municipio",39951,700,39251,556.30021023305,71815540
"1728","NA Vega Baja Municipio",59662,2492,57170,502.345731101138,118766810
"1729","NA Vieques Municipio",9301,1071,8230,70.736263351907,131488427
"1730","NA Villalba Municipio",26073,3509,22564,282.485477832534,92298550
"1731","NA Yabucoa Municipio",37941,5749,32192,265.312082558804,143005172
"1732","NA Yauco Municipio",42043,7740,34303,238.048062732218,176615594
"1733","Nebraska Adams County",31364,7052,24312,21.4988479838469,1458868867
"1734","Nebraska Antelope County",6685,6685,0,3.01101179486512,2220183930
"1735","Nebraska Arthur County",460,460,0,0.248278271015877,1852759801
"1736","Nebraska Banner County",690,690,0,0.357063954325658,1932426927
"1737","Nebraska Blaine County",478,478,0,0.259619471439067,1841156202
"1738","Nebraska Boone County",5505,5505,0,3.09588663776208,1778165884
"1739","Nebraska Box Butte County",11308,2822,8486,4.06033038673527,2784995043
"1740","Nebraska Boyd County",2099,2099,0,1.50096097864647,1398437421
"1741","Nebraska Brown County",3145,3145,0,0.994234335192587,3163238171
"1742","Nebraska Buffalo County",46102,14873,31229,18.386387142028,2507398525
"1743","Nebraska Burt County",6858,6858,0,5.38647162204227,1273189665
"1744","Nebraska Butler County",8395,5516,2879,5.54161662029616,1514900899
"1745","Nebraska Cass County",25241,18415,6826,17.4825970256378,1443778631
"1746","Nebraska Cedar County",8852,8852,0,4.61667171582539,1917398625
"1747","Nebraska Chase County",3966,3966,0,1.71204080291046,2316533574
"1748","Nebraska Cherry County",5713,3000,2713,0.370074754629502,15437421571
"1749","Nebraska Cheyenne County",9998,3625,6373,3.22685974378503,3098368319
"1750","Nebraska Clay County",6542,6542,0,4.41364140732965,1482222817
"1751","Nebraska Colfax County",10515,4260,6255,9.86218356768995,1066193904
"1752","Nebraska Cuming County",9139,5959,3180,6.18379198592021,1477895767
"1753","Nebraska Custer County",10939,7402,3537,1.63988977221923,6670570294
"1754","Nebraska Dakota County",21006,4430,16576,30.6918498764284,684416224
"1755","Nebraska Dawes County",9182,3667,5515,2.53869147598737,3616823898
"1756","Nebraska Dawson County",24326,6484,17842,9.27091229684535,2623905741
"1757","Nebraska Deuel County",1941,1941,0,1.70381385538162,1139208954
"1758","Nebraska Dixon County",6000,6000,0,4.86446701062583,1233434205
"1759","Nebraska Dodge County",36691,9220,27471,26.7946279343761,1369341649
"1760","Nebraska Douglas County",517110,11224,505886,607.868839379618,850693384
"1761","Nebraska Dundy County",2008,2008,0,0.843005337251932,2381954077
"1762","Nebraska Fillmore County",5890,5890,0,3.95248228096993,1490202759
"1763","Nebraska Franklin County",3225,3225,0,2.16246143486393,1491356076
"1764","Nebraska Frontier County",2756,2756,0,1.09183951465049,2524180489
"1765","Nebraska Furnas County",4959,4959,0,2.66248950787058,1862542551
"1766","Nebraska Gage County",22311,9906,12405,10.1167516214132,2205352156
"1767","Nebraska Garden County",2057,2057,0,0.466009650934363,4414071674
"1768","Nebraska Garfield County",2049,2049,0,1.38844703995634,1475749482
"1769","Nebraska Gosper County",2044,2044,0,1.72254507956936,1186616260
"1770","Nebraska Grant County",614,614,0,0.305410343438149,2010409972
"1771","Nebraska Greeley County",2538,2538,0,1.7197405256308,1475804031
"1772","Nebraska Hall County",58607,8571,50036,41.4218505687647,1414881257
"1773","Nebraska Hamilton County",9124,4658,4466,6.48911121768012,1406047715
"1774","Nebraska Harlan County",3423,3423,0,2.38791147545461,1433470225
"1775","Nebraska Hayes County",967,967,0,0.523602305805505,1846821508
"1776","Nebraska Hitchcock County",2908,2908,0,1.58151545618645,1838742700
"1777","Nebraska Holt County",10435,6753,3682,1.67011204646638,6248083787
"1778","Nebraska Hooker County",736,736,0,0.394068506750677,1867695559
"1779","Nebraska Howard County",6274,6274,0,4.2547813846701,1474576349
"1780","Nebraska Jefferson County",7547,3635,3912,5.11047264429373,1476771431
"1781","Nebraska Johnson County",5217,5217,0,5.35643736334308,973968264
"1782","Nebraska Kearney County",6489,3540,2949,4.85316457039026,1337065724
"1783","Nebraska Keith County",8368,3944,4424,3.04342783931085,2749531266
"1784","Nebraska Keya Paha County",824,824,0,0.411537701592143,2002246688
"1785","Nebraska Kimball County",3821,3821,0,1.54993212453355,2465269246
"1786","Nebraska Knox County",8701,8701,0,3.0310587349271,2870614119
"1787","Nebraska Lancaster County",285407,23555,261852,131.570009423478,2169240553
"1788","Nebraska Lincoln County",36288,11075,25213,5.46431523918673,6640905294
"1789","Nebraska Logan County",763,763,0,0.516237102052811,1478003028
"1790","Nebraska Loup County",632,632,0,0.429387471210479,1471864091
"1791","Nebraska Madison County",34876,9732,25144,23.5109093929555,1483396470
"1792","Nebraska McPherson County",539,539,0,0.242275824855982,2224737034
"1793","Nebraska Merrick County",7845,4620,3225,6.24683585720061,1255835783
"1794","Nebraska Morrill County",5042,5042,0,1.36723905147922,3687723807
"1795","Nebraska Nance County",3735,3735,0,3.26536248619353,1143824006
"1796","Nebraska Nemaha County",7248,3774,3474,6.86939162580786,1055115270
"1797","Nebraska Nuckolls County",4500,4500,0,3.02085352990692,1489645213
"1798","Nebraska Otoe County",15740,8674,7066,9.87158291715753,1594475793
"1799","Nebraska Pawnee County",2773,2773,0,2.48370300538677,1116478095
"1800","Nebraska Perkins County",2970,2970,0,1.29817443311184,2287828141
"1801","Nebraska Phelps County",9188,3848,5340,6.57201761533045,1398048596
"1802","Nebraska Pierce County",7266,7266,0,4.89389392391164,1484707293
"1803","Nebraska Platte County",32237,10131,22106,18.4654002113382,1745805649
"1804","Nebraska Polk County",5406,5406,0,4.76170342363182,1135308002
"1805","Nebraska Red Willow County",11055,3492,7563,5.95320235608912,1856983744
"1806","Nebraska Richardson County",8363,4230,4133,5.85128468187635,1429258779
"1807","Nebraska Rock County",1526,1526,0,0.584331292779151,2611532223
"1808","Nebraska Saline County",14200,7252,6948,9.55136421664264,1486698620
"1809","Nebraska Sarpy County",158840,8377,150463,256.614893486402,618982000
"1810","Nebraska Saunders County",20780,13816,6964,10.6942699353396,1943096642
"1811","Nebraska Scotts Bluff County",36970,11024,25946,19.3050870778563,1915039277
"1812","Nebraska Seward County",16750,10114,6636,11.3176407651739,1479990428
"1813","Nebraska Sheridan County",5469,5469,0,0.865101221772711,6321803579
"1814","Nebraska Sherman County",3152,3152,0,2.15081835547307,1465488702
"1815","Nebraska Sioux County",1311,1311,0,0.244917061593576,5352832471
"1816","Nebraska Stanton County",6129,4504,1625,5.52968419509823,1108381561
"1817","Nebraska Thayer County",5228,5228,0,3.5178065976857,1486153333
"1818","Nebraska Thomas County",647,647,0,0.350246060389412,1847272741
"1819","Nebraska Thurston County",6940,6940,0,6.80807777329091,1019377309
"1820","Nebraska Valley County",4260,4260,0,2.8955219637443,1471237329
"1821","Nebraska Washington County",20234,12390,7844,20.0339409851862,1009986004
"1822","Nebraska Wayne County",9595,4038,5557,8.3642514904,1147143891
"1823","Nebraska Webster County",3812,3812,0,2.56007636753472,1489018081
"1824","Nebraska Wheeler County",818,818,0,0.549098212783054,1489715284
"1825","Nebraska York County",13665,6032,7633,9.21571600959607,1482793088
"1826","Nevada Carson City",55274,2675,52599,147.525981890581,374672985
"1827","Nevada Churchill County",24877,8636,16241,1.94810795299397,12769826211
"1828","Nevada Clark County",1951269,25485,1925784,95.4692803875183,20438710673
"1829","Nevada Douglas County",46997,14829,32168,25.5673553621748,1838164305
"1830","Nevada Elko County",48818,18478,30340,1.09778210275582,44469662857
"1831","Nevada Esmeralda County",783,783,0,0.084402129527472,9277017113
"1832","Nevada Eureka County",1987,1987,0,0.183726800717243,10814970882
"1833","Nevada Humboldt County",16528,6260,10268,0.661929025037632,24969444419
"1834","Nevada Lander County",5775,2255,3520,0.406137970704366,14219305794
"1835","Nevada Lincoln County",5345,5345,0,0.194082277685239,27539866410
"1836","Nevada Lyon County",51980,19200,32780,10.0288453826043,5183049296
"1837","Nevada Mineral County",4772,1523,3249,0.490955550085546,9719820866
"1838","Nevada Nye County",43946,15500,28446,0.933215089957117,47090965923
"1839","Nevada Pershing County",6753,6753,0,0.431925878869682,15634626982
"1840","Nevada Storey County",4010,3715,295,5.88874052721926,680960552
"1841","Nevada Washoe County",421407,17981,403426,25.8166798774174,16323051686
"1842","Nevada White Pine County",10030,5349,4681,0.436318004224904,22987820587
"1843","New Hampshire Belknap County",60088,39826,20262,57.9666338236667,1036596332
"1844","New Hampshire Carroll County",47818,43133,4685,19.8296707338204,2411436914
"1845","New Hampshire Cheshire County",77117,50138,26979,42.1348736973764,1830241632
"1846","New Hampshire Coos County",33055,21896,11159,7.11133557205979,4648212655
"1847","New Hampshire Grafton County",89118,61238,27880,20.1367456939937,4425640635
"1848","New Hampshire Hillsborough County",400721,84918,315803,176.592202556998,2269188527
"1849","New Hampshire Merrimack County",146445,79978,66467,60.5307259402284,2419349805
"1850","New Hampshire Rockingham County",295223,73505,221718,164.075050549005,1799316831
"1851","New Hampshire Strafford County",123143,39900,83243,128.859117114355,955640569
"1852","New Hampshire Sullivan County",43742,28066,15676,31.4320839516859,1391635377
"1853","New Jersey Atlantic County",274549,34905,239644,190.75601409647,1439267859
"1854","New Jersey Bergen County",905116,919,904197,1499.80247315956,603490137
"1855","New Jersey Burlington County",448734,29900,418834,216.957546682389,2068303255
"1856","New Jersey Camden County",513657,8308,505349,896.328431564652,573067842
"1857","New Jersey Cape May County",97265,16977,80288,149.365599312671,651187425
"1858","New Jersey Cumberland County",156898,36129,120769,125.239450964736,1252784157
"1859","New Jersey Essex County",783969,114,783855,2398.2785014611,326888224
"1860","New Jersey Gloucester County",288288,24060,264228,345.673352506992,833989655
"1861","New Jersey Hudson County",634266,0,634266,5301.71320049151,119634159
"1862","New Jersey Hunterdon County",128349,63622,64727,115.833614213611,1108046234
"1863","New Jersey Mercer County",366513,12764,353749,630.179223216612,581601212
"1864","New Jersey Middlesex County",809858,5461,804397,1012.21737236898,800083087
"1865","New Jersey Monmouth County",630380,23510,606870,519.187124438682,1214167244
"1866","New Jersey Morris County",492276,33324,458952,413.034377100834,1191852367
"1867","New Jersey Ocean County",576567,16711,559856,354.040295134811,1628534966
"1868","New Jersey Passaic County",501226,12080,489146,1048.38571595263,478093122
"1869","New Jersey Salem County",66083,29936,36147,76.8752378081556,859613601
"1870","New Jersey Somerset County",323444,18736,304708,413.773856798446,781692692
"1871","New Jersey Sussex County",149265,59482,89783,111.040499178274,1344239274
"1872","New Jersey Union County",536499,0,536499,2013.93717696519,266393116
"1873","New Jersey Warren County",108692,40830,67862,117.579599348002,924412063
"1874","New Mexico Bernalillo County",662564,27798,634766,220.374943544271,3006530549
"1875","New Mexico Catron County",3725,3725,0,0.207726028652767,17932273698
"1876","New Mexico Chaves County",65645,15918,49727,4.17881763938638,15708988921
"1877","New Mexico Cibola County",27213,15061,12152,2.31458189290451,11757199036
"1878","New Mexico Colfax County",13750,7199,6551,1.41267180099332,9733329419
"1879","New Mexico Curry County",48376,6806,41570,13.2959279946058,3638407189
"1880","New Mexico De Baca County",2022,2022,0,0.336127940930723,6015566556
"1881","New Mexico Dona Ana County",209233,40362,168871,21.2173543738091,9861408558
"1882","New Mexico Eddy County",53829,11226,42603,4.9772173407854,10815079253
"1883","New Mexico Grant County",29514,12500,17014,2.87645074631307,10260561575
"1884","New Mexico Guadalupe County",4687,2066,2621,0.597152796437644,7848912419
"1885","New Mexico Harding County",695,695,0,0.12625186627507,5504869120
"1886","New Mexico Hidalgo County",4894,4894,0,0.549799325936612,8901429611
"1887","New Mexico Lea County",64727,13613,51114,5.69155644695356,11372460346
"1888","New Mexico Lincoln County",20497,10901,9596,1.63812610013415,12512467751
"1889","New Mexico Los Alamos County",17950,2018,15932,63.4858205091887,282740301
"1890","New Mexico Luna County",25095,10192,14903,3.26766216646277,7679802477
"1891","New Mexico McKinley County",71492,41021,30471,5.06498767032464,14114940579
"1892","New Mexico Mora County",4881,4881,0,0.975814101823014,5001977314
"1893","New Mexico Otero County",63797,18880,44917,3.72469097644784,17128132348
"1894","New Mexico Quay County",9041,3758,5283,1.21444876862175,7444529760
"1895","New Mexico Rio Arriba County",40246,20028,20218,2.65133943243804,15179497392
"1896","New Mexico Roosevelt County",19846,7236,12610,3.13086825415744,6338816708
"1897","New Mexico San Juan County",130044,43778,86266,9.10750309621944,14278776370
"1898","New Mexico San Miguel County",29393,13784,15609,2.40651677623258,12213918594
"1899","New Mexico Sandoval County",131561,22442,109119,13.6892412428314,9610539961
"1900","New Mexico Santa Fe County",144170,36274,107896,29.1525842155003,4945359181
"1901","New Mexico Sierra County",11988,4070,7918,1.10759538559952,10823447042
"1902","New Mexico Socorro County",17866,8875,8991,1.03782684349299,17214817782
"1903","New Mexico Taos County",32937,19251,13686,5.77231504714037,5706029510
"1904","New Mexico Torrance County",16383,16184,199,1.89112254606107,8663108604
"1905","New Mexico Union County",4549,4549,0,0.459334879826463,9903449966
"1906","New Mexico Valencia County",76569,12811,63758,27.7285235262864,2761380350
"1907","New York Albany County",304204,29496,274708,224.661250147763,1354056384
"1908","New York Allegany County",48946,38540,10406,18.3600660561462,2665894548
"1909","New York Broome County",200600,52270,148330,109.741885662544,1827925580
"1910","New York Cattaraugus County",80317,49598,30719,23.702034338935,3388612085
"1911","New York Cayuga County",80026,44640,35386,44.6775612765292,1791189978
"1912","New York Chautauqua County",134905,59173,75732,49.1282905085546,2745973829
"1913","New York Chemung County",88830,21478,67352,84.1962048644541,1055035677
"1914","New York Chenango County",50477,42104,8373,21.811106432223,2314279661
"1915","New York Clinton County",82128,52690,29438,30.5532819339518,2688025469
"1916","New York Columbia County",63096,46248,16848,38.3823806506501,1643879273
"1917","New York Cortland County",49336,21843,27493,38.1921857680921,1291782573
"1918","New York Delaware County",47980,37599,10381,12.8429474810621,3735902531
"1919","New York Dutchess County",297488,75560,221928,144.364577331483,2060671707
"1920","New York Erie County",919040,86425,832615,340.314166408263,2700563452
"1921","New York Essex County",39370,29471,9899,8.47207873623661,4647029522
"1922","New York Franklin County",51599,32340,19259,12.2289955728102,4219398044
"1923","New York Fulton County",55531,27973,27558,43.2734201631823,1283258864
"1924","New York Genesee County",60079,35979,24100,47.0581273583105,1276697637
"1925","New York Greene County",49221,36001,13220,29.3656815545352,1676140222
"1926","New York Hamilton County",4836,4836,0,1.08723609076426,4447975965
"1927","New York Herkimer County",64519,33427,31092,17.6489282126137,3655689412
"1928","New York Jefferson County",116229,55847,60382,35.3749254274451,3285632368
"1929","New York Kings County",2504700,37,2504663,13656.1390830577,183412016
"1930","New York Lewis County",27087,23525,3562,8.20469066263439,3301404174
"1931","New York Livingston County",65393,35739,29654,39.9649848233592,1636257346
"1932","New York Madison County",73442,43291,30151,43.3022175338471,1696033233
"1933","New York Monroe County",744344,48010,696334,437.295257837883,1702154292
"1934","New York Montgomery County",50219,20559,29660,48.1082109669788,1043875858
"1935","New York Nassau County",1339532,2575,1336957,1816.53356031554,737411094
"1936","New York New York City County",1733901,13,1733888,15820.5754157885,149750624.666667
"1937","New York Niagara County",216469,48577,167892,160.003270595197,1352903595
"1938","New York Oneida County",234878,77472,157406,74.7977223699611,3140175831
"1939","New York Onondaga County",467026,58787,408239,231.657425986933,2016019983
"1940","New York Ontario County",107931,51233,56698,64.7021086407075,1668121832
"1941","New York Orange County",372813,83289,289524,177.339420924593,2102256780
"1942","New York Orleans County",42883,26107,16776,42.3177464151553,1013357365
"1943","New York Oswego County",122109,75408,46701,49.5419179860721,2464761256
"1944","New York Otsego County",62259,43934,18325,23.9975311948604,2594391877
"1945","New York Putnam County",99710,20490,79220,167.157256702211,596504166
"1946","New York Rensselaer County",159429,48645,110784,94.3484422064315,1689789426
"1947","New York Richmond County",468730,0,468730,3100.50677043309,151178512
"1948","New York Rockland County",311687,2236,309451,693.419068451515,449492975
"1949","New York Saratoga County",219607,65798,153809,104.681985519041,2097849013
"1950","New York Schenectady County",154727,12620,142107,292.106596058504,529693619
"1951","New York Schoharie County",32749,27131,5618,20.3346287974022,1610503950
"1952","New York Schuyler County",18343,14886,3457,21.5703705805423,850379456
"1953","New York Seneca County",35251,20677,14574,42.0458976291447,838393327
"1954","New York St. Lawrence County",111944,69396,42548,16.1252760329949,6942144728
"1955","New York Steuben County",98990,59761,39229,27.4855282675399,3601531651
"1956","New York Suffolk County",1493350,38844,1454506,632.185697337311,2362201496
"1957","New York Sullivan County",77547,57513,20034,30.9266360761383,2507450206
"1958","New York Tioga County",51125,33568,17557,38.0628749109422,1343172320
"1959","New York Tompkins County",101564,44021,57543,82.6170591275375,1229334487
"1960","New York Ulster County",182493,84020,98473,62.6745614018271,2911755518
"1961","New York Warren County",65707,22294,43413,29.2629907856303,2245395916
"1962","New York Washington County",63216,42923,20293,29.365147706045,2152756071
"1963","New York Wayne County",93772,56917,36855,59.9602495107808,1563902765
"1964","New York Westchester County",949113,31069,918044,851.235795469655,1114982482
"1965","New York Wyoming County",42155,27014,15141,27.4588564178443,1535205959
"1966","New York Yates County",25348,18054,7294,28.9431529973216,875785717
"1967","North Carolina Alamance County",151131,43160,107971,137.641090827052,1098007863
"1968","North Carolina Alexander County",37198,27072,10126,55.2406060374151,673381461
"1969","North Carolina Alleghany County",11155,11155,0,18.3228967668318,608801116
"1970","North Carolina Anson County",26948,21157,5791,19.5778562452722,1376453053
"1971","North Carolina Ashe County",27281,23152,4129,24.7181313721848,1103683753
"1972","North Carolina Avery County",17797,15801,1996,27.8099045869785,639951854
"1973","North Carolina Beaufort County",47759,31330,16429,22.2921023003287,2142417945
"1974","North Carolina Bertie County",21282,17716,3566,11.7508670159846,1811100404
"1975","North Carolina Bladen County",35190,32105,3085,15.5398621916542,2264498846
"1976","North Carolina Brunswick County",107431,46153,61278,48.9736244536252,2193650178
"1977","North Carolina Buncombe County",238318,57386,180932,140.123375716585,1700772614
"1978","North Carolina Burke County",90912,38776,52136,69.2198097145512,1313381247
"1979","North Carolina Cabarrus County",178011,34273,143738,189.994837956452,936925455
"1980","North Carolina Caldwell County",83029,28585,54444,67.9813452127696,1221349765
"1981","North Carolina Camden County",9980,9935,45,16.018284059104,623038021
"1982","North Carolina Carteret County",66469,21671,44798,50.6938286217427,1311185243
"1983","North Carolina Caswell County",23719,23528,191,21.5521051805393,1100542142
"1984","North Carolina Catawba County",154358,46763,107595,149.472673407358,1032683744
"1985","North Carolina Chatham County",63505,41864,21641,35.9424654294198,1766851529
"1986","North Carolina Cherokee County",27444,27444,0,23.266556428653,1179547136
"1987","North Carolina Chowan County",14793,10003,4790,33.1160081030325,446702391
"1988","North Carolina Clay County",10587,10587,0,19.034475125562,556201310
"1989","North Carolina Cleveland County",98078,54718,43360,81.5679603141027,1202408392
"1990","North Carolina Columbus County",58098,46824,11274,23.9324948724759,2427578082
"1991","North Carolina Craven County",103505,28680,74825,56.369387717083,1836191667
"1992","North Carolina Cumberland County",319431,42702,276729,189.069738667072,1689487711
"1993","North Carolina Currituck County",23547,23150,397,34.7201513117376,678194049
"1994","North Carolina Dare County",33920,9823,24097,34.1573199353126,993052150
"1995","North Carolina Davidson County",162878,77179,85699,113.787617564223,1431421129
"1996","North Carolina Davie County",41240,28987,12253,60.2898141012557,684029311
"1997","North Carolina Duplin County",58505,50586,7919,27.6750415738562,2113998631
"1998","North Carolina Durham County",267587,15059,252528,361.27561156064,740672748
"1999","North Carolina Edgecombe County",56552,25622,30930,43.2085581135455,1308814792
"2000","North Carolina Forsyth County",350670,25762,324908,331.729177858183,1057097245
"2001","North Carolina Franklin County",60619,51719,8900,47.6021380773708,1273451203
"2002","North Carolina Gaston County",206086,40491,165595,223.494863045629,922106205
"2003","North Carolina Gates County",12197,12197,0,13.8327553890865,881747682
"2004","North Carolina Graham County",8861,8861,0,11.7134369424836,756481641
"2005","North Carolina Granville County",59916,32804,27112,43.5195996069,1376758990
"2006","North Carolina Greene County",21362,21362,0,31.0156423897652,688749236
"2007","North Carolina Guilford County",488406,62000,426406,292.045179188188,1672364534
"2008","North Carolina Halifax County",54691,29919,24772,29.1626999068059,1875375057
"2009","North Carolina Harnett County",114678,64129,50549,74.417480893256,1541008895
"2010","North Carolina Haywood County",59036,32730,26306,41.1671735510307,1434055217
"2011","North Carolina Henderson County",106740,35513,71227,110.469240048131,966241824
"2012","North Carolina Hertford County",24669,16932,7737,26.9777072998131,914421664
"2013","North Carolina Hoke County",46952,20260,26692,46.3942433953231,1012022108
"2014","North Carolina Hyde County",5810,5810,0,3.6612613939707,1586884785
"2015","North Carolina Iredell County",159437,60446,98991,107.276758325495,1486221270
"2016","North Carolina Jackson County",40271,29434,10837,31.6832874544446,1271048658
"2017","North Carolina Johnston County",168878,87879,80999,82.40141063127,2049455206
"2018","North Carolina Jones County",10153,10153,0,8.32807781833346,1219128858
"2019","North Carolina Lee County",57866,24746,33120,87.6303891988962,660341698
"2020","North Carolina Lenoir County",59495,26776,32719,57.3430830267294,1037527054
"2021","North Carolina Lincoln County",78265,42696,35569,101.424781086633,771655597
"2022","North Carolina Macon County",33922,27141,6781,25.4042147230821,1335290241
"2023","North Carolina Madison County",20764,18816,1948,17.8326701864216,1164379747
"2024","North Carolina Martin County",24505,19144,5361,20.5140464766019,1194547357
"2025","North Carolina McDowell County",44996,31633,13363,39.4297366120146,1141169175
"2026","North Carolina Mecklenburg County",919628,9798,909830,677.819083878422,1356745512
"2027","North Carolina Mitchell County",15579,12875,2704,27.1653637138271,573487628
"2028","North Carolina Montgomery County",27798,21359,6439,21.8254311863489,1273651813
"2029","North Carolina Moore County",88247,44704,43543,48.8252637232603,1807404472
"2030","North Carolina Nash County",95840,45584,50256,68.4744391091793,1399646368
"2031","North Carolina New Hanover County",202667,4489,198178,408.543763296541,496071702
"2032","North Carolina Northampton County",22099,19749,2350,15.9013313117111,1389757849
"2033","North Carolina Onslow County",177772,46841,130931,89.9884980432711,1975496912
"2034","North Carolina Orange County",133801,38176,95625,129.814930019943,1030705790
"2035","North Carolina Pamlico County",13144,13144,0,15.0798378749467,871627408
"2036","North Carolina Pasquotank County",40661,16801,23860,69.1964488561475,587616860
"2037","North Carolina Pender County",52217,35902,16315,23.1791375311706,2252758539
"2038","North Carolina Perquimans County",13453,13453,0,21.0217138271516,639957337
"2039","North Carolina Person County",39464,29804,9660,38.8383702486085,1016108548
"2040","North Carolina Pitt County",168148,42770,125378,99.5779869657207,1688606138
"2041","North Carolina Polk County",20510,18925,1585,33.302421779715,615871126
"2042","North Carolina Randolph County",141752,79725,62027,69.9418972510632,2026710821
"2043","North Carolina Richmond County",46639,21235,25404,38.004659653707,1227191624
"2044","North Carolina Robeson County",134168,84007,50161,54.5737711252306,2458470383
"2045","North Carolina Rockingham County",93643,58007,35636,63.9301600696569,1464770304
"2046","North Carolina Rowan County",138428,53741,84687,104.51724171017,1324451332
"2047","North Carolina Rutherford County",67810,41392,26418,46.4088394175239,1461144059
"2048","North Carolina Sampson County",63431,53893,9538,25.9233698908607,2446865522
"2049","North Carolina Scotland County",36157,17497,18660,43.7840068208549,825803818
"2050","North Carolina Stanly County",60585,41024,19561,59.2074054881304,1023267267
"2051","North Carolina Stokes County",47401,35881,11520,40.7738260591539,1162535003
"2052","North Carolina Surry County",73673,50691,22982,53.4519164652727,1378304182
"2053","North Carolina Swain County",13981,13981,0,10.2237353513044,1367504099
"2054","North Carolina Transylvania County",33090,19734,13356,33.7521009917861,980383414
"2055","North Carolina Tyrrell County",4407,4407,0,4.37378051590487,1007595142
"2056","North Carolina Union County",201292,54931,146361,123.066950011019,1635630037
"2057","North Carolina Vance County",45422,24564,20858,69.1768562085316,656606884
"2058","North Carolina Wake County",900993,54973,846020,416.508133086216,2163206258
"2059","North Carolina Warren County",20972,20972,0,18.8988656662384,1109696231
"2060","North Carolina Washington County",13228,8963,4265,14.6706451042875,901664508
"2061","North Carolina Watauga County",51079,28316,22763,63.0982121467042,809515805
"2062","North Carolina Wayne County",122623,56902,65721,85.6013818754714,1432488557
"2063","North Carolina Wilkes County",69340,50473,18867,35.4939679393809,1953571382
"2064","North Carolina Wilson County",81234,31406,49828,85.1895993824594,953567109
"2065","North Carolina Yadkin County",38406,32521,5885,44.2871796641823,867203563
"2066","North Carolina Yancey County",17818,17818,0,22.0077733906139,809623022
"2067","North Dakota Adams County",2343,2343,0,0.915977801547339,2557922251
"2068","North Dakota Barnes County",11066,4377,6689,2.86453393008911,3863106624
"2069","North Dakota Benson County",6660,6660,0,1.85167845084564,3596736786
"2070","North Dakota Billings County",783,783,0,0.263147652549793,2975515808
"2071","North Dakota Bottineau County",6429,6429,0,1.48778462900247,4321189959
"2072","North Dakota Bowman County",3151,3151,0,1.04716850736857,3009066810
"2073","North Dakota Burke County",1968,1968,0,0.688538777338882,2858226820
"2074","North Dakota Burleigh County",81308,15081,66227,19.2283307074629,4228552194
"2075","North Dakota Cass County",149778,15629,134149,32.7658189348258,4571166077
"2076","North Dakota Cavalier County",3993,3993,0,1.0355701690047,3855846875
"2077","North Dakota Dickey County",5289,5289,0,1.80481458316718,2930494938
"2078","North Dakota Divide County",2071,2071,0,0.634221388352745,3265421252
"2079","North Dakota Dunn County",3536,3536,0,0.679753409646515,5201886375
"2080","North Dakota Eddy County",2385,2385,0,1.46127686253385,1632134239
"2081","North Dakota Emmons County",3550,3550,0,0.9074623444014,3912008054
"2082","North Dakota Foster County",3343,3343,0,2.03121302040138,1645814578
"2083","North Dakota Golden Valley County",1680,1680,0,0.648142060063759,2592024347
"2084","North Dakota Grand Forks County",66861,11212,55649,17.9724375143418,3720196548
"2085","North Dakota Grant County",2394,2394,0,0.557113387031516,4297150375
"2086","North Dakota Griggs County",2420,2420,0,1.31821084036132,1835821650
"2087","North Dakota Hettinger County",2477,2477,0,0.844689244716164,2932439374
"2088","North Dakota Kidder County",2435,2435,0,0.695800989276759,3499563866
"2089","North Dakota LaMoure County",4139,4139,0,1.39455187021244,2967978523
"2090","North Dakota Logan County",1990,1990,0,0.773901813823082,2571385626
"2091","North Dakota McHenry County",5395,5395,0,1.11156454886405,4853519308
"2092","North Dakota McIntosh County",2809,2809,0,1.11267506413642,2524546555
"2093","North Dakota McKenzie County",6360,6360,0,0.889609543738347,7149203878
"2094","North Dakota McLean County",8962,8962,0,1.63924741037828,5467142997
"2095","North Dakota Mercer County",8424,5475,2949,3.11856007534157,2701246664
"2096","North Dakota Morton County",27471,8751,18720,5.50629517312892,4989016959
"2097","North Dakota Mountrail County",7673,7673,0,1.62305649970411,4727500245
"2098","North Dakota Nelson County",3126,3126,0,1.22936095801109,2542784509
"2099","North Dakota Oliver County",1846,1846,0,0.986483157542729,1871293986
"2100","North Dakota Pembina County",7413,7413,0,2.5584970045738,2897404213
"2101","North Dakota Pierce County",4357,1533,2824,1.65152822399722,2638162604
"2102","North Dakota Ramsey County",11451,4007,7444,3.72519044633579,3073936800
"2103","North Dakota Ransom County",5457,5457,0,2.44325684620694,2233494202
"2104","North Dakota Renville County",2470,2470,0,1.0873600058,2271556786
"2105","North Dakota Richland County",16321,8487,7834,4.3889577247468,3718650537
"2106","North Dakota Rolette County",13937,13937,0,5.95862177585387,2338963694
"2107","North Dakota Sargent County",3829,3829,0,1.72202930234653,2223539399
"2108","North Dakota Sheridan County",1321,1321,0,0.524528975531145,2518450003
"2109","North Dakota Sioux County",4153,4153,0,1.46557956197503,2833691263
"2110","North Dakota Slope County",727,727,0,0.231040602465619,3146633069
"2111","North Dakota Stark County",24199,6613,17586,7.0001047909815,3456948249
"2112","North Dakota Steele County",1975,1975,0,1.07067579495973,1844629354
"2113","North Dakota Stutsman County",21100,5816,15284,3.66686161226512,5754239519
"2114","North Dakota Towner County",2246,2246,0,0.846397359120855,2653599962
"2115","North Dakota Traill County",8121,8121,0,3.63772662225524,2232438235
"2116","North Dakota Walsh County",11119,6900,4219,3.34890837762411,3320186385
"2117","North Dakota Ward County",61675,13504,48171,11.8278926026523,5214369294
"2118","North Dakota Wells County",4207,4207,0,1.27794820902884,3291995693
"2119","North Dakota Williams County",22398,7271,15127,4.16285282773225,5380444836
"2120","Ohio Adams County",28550,25417,3133,18.879666117251,1512208946
"2121","Ohio Allen County",106331,27530,78801,102.000185056697,1042458893
"2122","Ohio Ashland County",53139,32913,20226,48.5094992830752,1095434931
"2123","Ohio Ashtabula County",101497,47063,54434,55.8291403639562,1817993244
"2124","Ohio Athens County",64757,27956,36801,49.6483405973105,1304313482
"2125","Ohio Auglaize County",45949,17983,27966,44.1993580682197,1039585234
"2126","Ohio Belmont County",70400,38484,31916,51.0808784626818,1378206525
"2127","Ohio Brown County",44846,34334,10512,35.3358634781273,1269135535
"2128","Ohio Butler County",368130,34394,333736,304.323051422511,1209668470
"2129","Ohio Carroll County",28836,20460,8376,28.2143786097485,1022032078
"2130","Ohio Champaign County",40097,28398,11699,36.1153731115386,1110247425
"2131","Ohio Clark County",138333,32654,105679,134.375604321333,1029450254
"2132","Ohio Clermont County",197363,44834,152529,168.551837707202,1170933540
"2133","Ohio Clinton County",42040,22970,19070,39.7170376469288,1058487805
"2134","Ohio Columbiana County",107841,47304,60537,78.2819470566999,1377597314
"2135","Ohio Coshocton County",36901,22683,14218,25.2655026312835,1460529028
"2136","Ohio Crawford County",43784,15440,28344,42.0748779804034,1040620962
"2137","Ohio Cuyahoga County",1280122,7447,1272675,1081.07551553356,1184118946
"2138","Ohio Darke County",52959,35113,17846,34.1875580056034,1549072326
"2139","Ohio Defiance County",39037,17118,21919,36.6312189784731,1065675702
"2140","Ohio Delaware County",174214,33641,140573,151.804910535167,1147617685
"2141","Ohio Erie County",77079,20409,56670,118.304249641241,651531963
"2142","Ohio Fairfield County",146156,50734,95422,111.875324330876,1306418559
"2143","Ohio Fayette County",29030,13862,15168,27.5830310948593,1052458662
"2144","Ohio Franklin County",1163414,15753,1147661,844.056068212723,1378361040
"2145","Ohio Fulton County",42698,23979,18719,40.6612221711095,1050091407
"2146","Ohio Gallia County",30934,25165,5769,25.601098803729,1208307512
"2147","Ohio Geauga County",93389,59740,33649,90.1072767610526,1036420180
"2148","Ohio Greene County",161573,24090,137483,150.783769175679,1071554325
"2149","Ohio Guernsey County",40087,24621,15466,29.6363160333792,1352631007
"2150","Ohio Hamilton County",802374,17908,784466,763.218756065688,1051302780
"2151","Ohio Hancock County",74782,23265,51517,54.3390805435626,1376210257
"2152","Ohio Hardin County",32058,17753,14305,26.3127929311707,1218342731
"2153","Ohio Harrison County",15864,13343,2521,15.2237979922615,1042052713
"2154","Ohio Henry County",28215,19491,8724,26.1865518052267,1077461447
"2155","Ohio Highland County",43589,31821,11768,30.429047425564,1432479939
"2156","Ohio Hocking County",29380,20813,8567,26.9239435132769,1091222019
"2157","Ohio Holmes County",42366,39398,2968,38.7131868636305,1094355785
"2158","Ohio Huron County",59626,29994,29632,46.840228832578,1272965600
"2159","Ohio Jackson County",33225,21457,11768,30.5213566369971,1088582018
"2160","Ohio Jefferson County",69709,27174,42535,65.9145505265392,1057566189
"2161","Ohio Knox County",60921,33933,26988,44.7611468760258,1361024108
"2162","Ohio Lake County",230041,15020,215021,390.426995049214,589203623
"2163","Ohio Lawrence County",62450,28675,33775,53.1840495017954,1174224238
"2164","Ohio Licking County",166492,59151,107341,94.1874135590602,1767667183
"2165","Ohio Logan County",45858,26100,19758,38.6229028823047,1187326601
"2166","Ohio Lorain County",301356,35373,265983,236.925020976468,1271946706
"2167","Ohio Lucas County",441815,20589,421226,500.464053074448,882810658
"2168","Ohio Madison County",43435,21060,22375,35.9975235759124,1206610780
"2169","Ohio Mahoning County",238823,36202,202621,224.015796027515,1066098928
"2170","Ohio Marion County",66501,20117,46384,63.5930872308876,1045726869
"2171","Ohio Medina County",172332,51345,120987,157.912836609702,1091310901
"2172","Ohio Meigs County",23770,19324,4446,21.3384823094138,1113949889
"2173","Ohio Mercer County",40814,25043,15771,34.0759314027873,1197736887
"2174","Ohio Miami County",102506,31570,70936,97.3431265460531,1053037884
"2175","Ohio Monroe County",14642,14298,344,12.4051900919369,1180312425
"2176","Ohio Montgomery County",535153,23179,511974,447.670463330092,1195417263
"2177","Ohio Morgan County",15054,12267,2787,13.9578723966336,1078531138
"2178","Ohio Morrow County",34827,30940,3887,33.1137385465966,1051738690
"2179","Ohio Muskingum County",86074,40483,45591,50.0066541721491,1721250930
"2180","Ohio Noble County",14645,9157,5488,14.2067643244658,1030846973
"2181","Ohio Ottawa County",41428,20485,20943,62.7477090315849,660231276
"2182","Ohio Paulding County",19614,16064,3550,18.1852110114896,1078568733
"2183","Ohio Perry County",36058,27131,8927,34.1251109243554,1056641254
"2184","Ohio Pickaway County",55698,27774,27924,42.8969488042176,1298414026
"2185","Ohio Pike County",28709,21313,7396,25.1761770491758,1140324043
"2186","Ohio Portage County",161419,52967,108452,127.875769449302,1262311075
"2187","Ohio Preble County",42270,29261,13009,38.4809669696203,1098465120
"2188","Ohio Putnam County",34499,29207,5292,27.605263352548,1249725444
"2189","Ohio Richland County",124475,39900,84575,97.0383943627421,1282739691
"2190","Ohio Ross County",78064,45801,32263,43.7336255033524,1784988075
"2191","Ohio Sandusky County",60944,26903,34041,57.6091002111546,1057888420
"2192","Ohio Scioto County",79499,43150,36349,50.3016552917607,1580445008
"2193","Ohio Seneca County",56745,26959,29786,39.7616799330443,1427127830
"2194","Ohio Shelby County",49423,25261,24162,46.8076664329933,1055874043
"2195","Ohio Stark County",375586,50817,324769,252.080626953526,1489943930
"2196","Ohio Summit County",541781,21003,520778,506.805030651685,1069012672
"2197","Ohio Trumbull County",210312,57359,152953,131.331678737273,1601380581
"2198","Ohio Tuscarawas County",92582,38496,54086,62.9736784498598,1470169796
"2199","Ohio Union County",52300,26125,26175,46.7726020134552,1118175978
"2200","Ohio Van Wert County",28744,14581,14163,27.1242696792276,1059715168
"2201","Ohio Vinton County",13435,13435,0,12.579487190627,1068008560
"2202","Ohio Warren County",212693,36724,175969,204.630949247648,1039398003
"2203","Ohio Washington County",61778,34943,26835,37.7431778336991,1636799113
"2204","Ohio Wayne County",114520,58406,56114,79.6794853044785,1437258280
"2205","Ohio Williams County",37642,23951,13691,34.5245850857202,1090295507
"2206","Ohio Wood County",125488,37077,88411,78.501011377071,1598552653
"2207","Ohio Wyandot County",22615,12985,9630,21.4609323332571,1053775281
"2208","Oklahoma Adair County",22683,18894,3789,15.2716816923607,1485298113
"2209","Oklahoma Alfalfa County",5642,5642,0,2.51414041558353,2244106958
"2210","Oklahoma Atoka County",14182,14182,0,5.61312544884571,2526578130
"2211","Oklahoma Beaver County",5636,5636,0,1.19915445661808,4699978363
"2212","Oklahoma Beckham County",22119,7223,14896,9.47010788617576,2335665049
"2213","Oklahoma Blaine County",11943,6859,5084,4.96671439262082,2404607766
"2214","Oklahoma Bryan County",42416,26014,16402,18.106625183291,2342567959
"2215","Oklahoma Caddo County",29600,23671,5929,8.94056339881498,3310753325
"2216","Oklahoma Canadian County",115541,26006,89535,49.753897387588,2322250237
"2217","Oklahoma Carter County",47557,26669,20888,22.3332628588972,2129424630
"2218","Oklahoma Cherokee County",46987,28215,18772,24.208166258135,1940956597
"2219","Oklahoma Choctaw County",15205,10177,5028,7.62073382881322,1995214679
"2220","Oklahoma Cimarron County",2475,2475,0,0.520838952080816,4751948736
"2221","Oklahoma Cleveland County",255755,43181,212574,183.284566497834,1395398450
"2222","Oklahoma Coal County",5925,5925,0,4.42759110556325,1338199454
"2223","Oklahoma Comanche County",124098,27041,97057,44.8097885139675,2769439538
"2224","Oklahoma Cotton County",6193,3687,2506,3.77952281974876,1638566638
"2225","Oklahoma Craig County",15029,9027,6002,7.62159384269502,1971897258
"2226","Oklahoma Creek County",69967,37743,32224,28.4320047989593,2460853552
"2227","Oklahoma Custer County",27469,8330,19139,10.7257848112076,2561024716
"2228","Oklahoma Delaware County",41487,33653,7834,21.699713442383,1911868565
"2229","Oklahoma Dewey County",4810,4810,0,1.8581242573947,2588632047
"2230","Oklahoma Ellis County",4151,4151,0,1.30141315067793,3189609693
"2231","Oklahoma Garfield County",60580,12971,47609,22.0980819566689,2741414396
"2232","Oklahoma Garvin County",27576,18945,8631,13.2737575364387,2077482576
"2233","Oklahoma Grady County",52431,33496,18935,18.3950799663274,2850273013
"2234","Oklahoma Grant County",4527,4527,0,1.74636273369817,2592244963
"2235","Oklahoma Greer County",6239,3285,2954,3.76786994758006,1655842714
"2236","Oklahoma Harmon County",2922,2922,0,2.10015374915103,1391326707
"2237","Oklahoma Harper County",3685,3685,0,1.36935865570088,2691040791
"2238","Oklahoma Haskell County",12769,9926,2843,8.55153704549321,1493181861
"2239","Oklahoma Hughes County",14003,8235,5768,6.71920892914048,2084025091
"2240","Oklahoma Jackson County",26446,6546,19900,12.7214194784401,2078856062
"2241","Oklahoma Jefferson County",6472,6472,0,3.29302661464052,1965365227
"2242","Oklahoma Johnston County",10957,10957,0,6.57996247846808,1665207064
"2243","Oklahoma Kay County",46562,11396,35166,19.546724243503,2382087117
"2244","Oklahoma Kingfisher County",15034,10890,4144,6.4628305307022,2326225317
"2245","Oklahoma Kiowa County",9446,5824,3622,3.59242333350834,2629422850
"2246","Oklahoma Latimer County",11154,8175,2979,5.96413612236935,1870178643
"2247","Oklahoma Le Flore County",50384,36728,13656,12.2408740388918,4116045949
"2248","Oklahoma Lincoln County",34273,31569,2704,13.8955050229794,2466481063
"2249","Oklahoma Logan County",41848,23173,18675,21.7220486590843,1926521787
"2250","Oklahoma Love County",9423,9423,0,7.07835733000882,1331241072
"2251","Oklahoma Major County",7527,7527,0,3.04316962439608,2473407969
"2252","Oklahoma Marshall County",15840,11421,4419,16.4812366957324,961092926
"2253","Oklahoma Mayes County",41259,31934,9325,24.3065905695236,1697440860
"2254","Oklahoma McClain County",34506,26627,7879,23.3446808489795,1478109734
"2255","Oklahoma McCurtain County",33151,22958,10193,6.91872225861288,4791491660
"2256","Oklahoma McIntosh County",20252,17680,2572,12.6425148824209,1601896473
"2257","Oklahoma Murray County",13488,6164,7324,12.5048516678213,1078621351
"2258","Oklahoma Muskogee County",70990,29189,41801,33.8199500900431,2099056912
"2259","Oklahoma Noble County",11561,6509,5052,6.0988622596985,1895599459
"2260","Oklahoma Nowata County",10536,6104,4432,7.19006612929566,1465355090
"2261","Oklahoma Okfuskee County",12191,9039,3152,7.60947474994764,1602081668
"2262","Oklahoma Oklahoma County",718633,45097,673536,391.448060984807,1835832315
"2263","Oklahoma Okmulgee County",40069,19454,20615,22.1850734191803,1806124291
"2264","Oklahoma Osage County",47472,28233,19239,8.15944819376158,5818040494
"2265","Oklahoma Ottawa County",31848,15704,16144,26.1173067772567,1219421293
"2266","Oklahoma Pawnee County",16577,13449,3128,11.2692326080943,1470996347
"2267","Oklahoma Payne County",77350,26093,51257,43.617475258513,1773371786
"2268","Oklahoma Pittsburg County",45837,23797,22040,13.5567092840852,3381130261
"2269","Oklahoma Pontotoc County",37492,20092,17400,20.0930558873686,1865918266
"2270","Oklahoma Pottawatomie County",69442,35187,34255,34.0391892359227,2040060341
"2271","Oklahoma Pushmataha County",11572,11572,0,3.20093015910263,3615199153
"2272","Oklahoma Roger Mills County",3647,3647,0,1.23395882415149,2955528117
"2273","Oklahoma Rogers County",86905,43709,43196,49.6634049230415,1749880020
"2274","Oklahoma Seminole County",25482,16480,9002,15.546894815654,1639041127
"2275","Oklahoma Sequoyah County",42391,28243,14148,24.3100485388648,1743764515
"2276","Oklahoma Stephens County",45048,19517,25531,19.9864880550671,2253922744
"2277","Oklahoma Texas County",20640,9302,11338,3.90403163678341,5286842403
"2278","Oklahoma Tillman County",7992,4093,3899,3.54219708292332,2256226803
"2279","Oklahoma Tulsa County",603403,28839,574564,408.551846801402,1476931275
"2280","Oklahoma Wagoner County",73085,27384,45701,50.25021475117,1454421645
"2281","Oklahoma Washington County",50976,12174,38802,47.3745485412583,1076020808
"2282","Oklahoma Washita County",11629,8753,2876,4.47580840682029,2598189856
"2283","Oklahoma Woods County",8878,3258,5620,2.66454531403569,3331900551
"2284","Oklahoma Woodward County",20081,8737,11344,6.24060241174959,3217798327
"2285","Oregon Baker County",16134,6616,9518,2.03019779341174,7947008933
"2286","Oregon Benton County",85579,16058,69521,48.8832844184993,1750680238
"2287","Oregon Clackamas County",375992,67974,308018,77.618353608909,4844112024
"2288","Oregon Clatsop County",37039,14435,22604,17.2496826947205,2147227903
"2289","Oregon Columbia County",49351,21523,27828,28.9865748030653,1702546794
"2290","Oregon Coos County",63043,24179,38864,15.2496256438599,4134068696
"2291","Oregon Crook County",20978,10073,10905,2.7188374163077,7715797890
"2292","Oregon Curry County",22364,8662,13702,5.30568592622109,4215100613
"2293","Oregon Deschutes County",157733,43603,114130,20.1780331687439,7817065156
"2294","Oregon Douglas County",107667,44335,63332,8.25453665208165,13043372940
"2295","Oregon Gilliam County",1871,1871,0,0.599595013466628,3120439560
"2296","Oregon Grant County",7445,7445,0,0.6347586255349,11728867794
"2297","Oregon Harney County",7422,3291,4131,0.282798988852985,26244789736
"2298","Oregon Hood River County",22346,11659,10687,16.5300452190905,1351841432
"2299","Oregon Jackson County",203206,40748,162458,28.1864281964289,7209356169
"2300","Oregon Jefferson County",21720,13710,8010,4.70923777898224,4612211364
"2301","Oregon Josephine County",82713,37191,45522,19.4769145989662,4246719858
"2302","Oregon Klamath County",66380,24946,41434,4.31396058482622,15387252316
"2303","Oregon Lake County",7895,5000,2895,0.374527904214525,21079871249
"2304","Oregon Lane County",351715,61631,290084,29.8252511538977,11792524334
"2305","Oregon Lincoln County",46034,17304,28730,18.140901677475,2537580591
"2306","Oregon Linn County",116672,36913,79759,19.6702053568192,5931407318
"2307","Oregon Malheur County",31313,15161,16152,1.22275381923194,25608588996
"2308","Oregon Marion County",315335,41289,274046,102.976293504617,3062209653
"2309","Oregon Morrow County",11173,5125,6048,2.12340017397411,5261843781
"2310","Oregon Multnomah County",735334,9870,725464,658.279585987802,1117054236
"2311","Oregon Polk County",75403,15025,60378,39.3004576291578,1918629058
"2312","Oregon Sherman County",1765,1765,0,0.8273341932559,2133357976
"2313","Oregon Tillamook County",25250,17575,7675,8.84206131659263,2855668955
"2314","Oregon Umatilla County",75889,22058,53831,9.11236924832755,8328130471
"2315","Oregon Union County",25748,10839,14909,4.88133731370788,5274784008
"2316","Oregon Wallowa County",7008,7008,0,0.860026031299332,8148590560
"2317","Oregon Wasco County",25213,8337,16876,4.08764031043828,6168106312
"2318","Oregon Washington County",529710,29611,500099,282.399492192923,1875746999
"2319","Oregon Wheeler County",1441,1441,0,0.32446336097312,4441179416
"2320","Oregon Yamhill County",99193,22421,76772,53.5001685260972,1854068926
"2321","Pennsylvania Adams County",101407,54431,46976,75.4885552454762,1343342705
"2322","Pennsylvania Allegheny County",1223348,30416,1192932,646.971378416451,1890884266
"2323","Pennsylvania Armstrong County",68941,46526,22415,40.7504015532073,1691787010
"2324","Pennsylvania Beaver County",170539,44046,126493,151.469039719932,1125900054
"2325","Pennsylvania Bedford County",49762,41698,8064,18.9798330070824,2621835502
"2326","Pennsylvania Berks County",411442,97660,313782,185.472792101305,2218341544
"2327","Pennsylvania Blair County",127089,29778,97311,93.3232281254857,1361815301
"2328","Pennsylvania Bradford County",62622,45197,17425,21.072438223564,2971749132
"2329","Pennsylvania Bucks County",625249,55207,570042,399.482176478241,1565148677
"2330","Pennsylvania Butler County",183862,77156,106706,90.019195285423,2042475490
"2331","Pennsylvania Cambria County",143679,45986,97693,80.5908679519697,1782819861
"2332","Pennsylvania Cameron County",5085,2408,2677,4.95501696256755,1026232612
"2333","Pennsylvania Carbon County",65249,30773,34476,66.0430043310755,987977465
"2334","Pennsylvania Centre County",153990,49612,104378,53.5676469431842,2874682925
"2335","Pennsylvania Chester County",498886,66235,432651,256.654219112469,1943805957
"2336","Pennsylvania Clarion County",39988,30615,9373,25.696688403286,1556153827
"2337","Pennsylvania Clearfield County",81642,43964,37678,27.53695129957,2964816225
"2338","Pennsylvania Clinton County",39238,17928,21310,17.0609751534151,2299868539
"2339","Pennsylvania Columbia County",67295,27491,39804,53.7824702213368,1251244127
"2340","Pennsylvania Crawford County",88765,56544,32221,33.8560044778093,2621839209
"2341","Pennsylvania Cumberland County",235406,52208,183198,166.631703096857,1412732365
"2342","Pennsylvania Dauphin County",268100,35720,232380,197.151994643537,1359864507
"2343","Pennsylvania Delaware County",558979,2593,556386,1173.94998352134,476152313
"2344","Pennsylvania Elk County",31946,17786,14160,14.9081956684749,2142848183
"2345","Pennsylvania Erie County",280566,56168,224398,135.552260995949,2069799485
"2346","Pennsylvania Fayette County",136606,65431,71175,66.7357561797995,2046968639
"2347","Pennsylvania Forest County",7716,7716,0,6.97394296208182,1106404231
"2348","Pennsylvania Franklin County",149618,60374,89244,74.8071267173363,2000050083
"2349","Pennsylvania Fulton County",14845,14845,0,13.0994604751819,1133252780
"2350","Pennsylvania Greene County",38686,25855,12831,25.9341646355085,1491700255
"2351","Pennsylvania Huntingdon County",45913,31525,14388,20.2679069173652,2265305450
"2352","Pennsylvania Indiana County",88880,53390,35490,41.4939742593438,2141997762
"2353","Pennsylvania Jefferson County",45200,27780,17420,26.7489908918035,1689783371
"2354","Pennsylvania Juniata County",24636,20264,4372,24.3056141754036,1013592984
"2355","Pennsylvania Lackawanna County",214437,34965,179472,180.349759593956,1189006298
"2356","Pennsylvania Lancaster County",519445,110419,409026,212.499126845999,2444457103
"2357","Pennsylvania Lawrence County",91108,36733,54375,98.2116963916983,927669548
"2358","Pennsylvania Lebanon County",133568,35470,98098,142.526871113834,937142582
"2359","Pennsylvania Lehigh County",349497,27700,321797,390.946832159263,893975782
"2360","Pennsylvania Luzerne County",320918,64135,256783,139.169504664753,2305950580
"2361","Pennsylvania Lycoming County",116111,42121,73990,36.4894297129251,3182044798
"2362","Pennsylvania McKean County",43450,27607,15843,17.1325417743634,2536109386
"2363","Pennsylvania Mercer County",116638,51891,64747,66.9578786153663,1741960803
"2364","Pennsylvania Mifflin County",46682,23559,23123,43.8507540515811,1064565502
"2365","Pennsylvania Monroe County",169842,65141,104701,107.805240105115,1575452175
"2366","Pennsylvania Montgomery County",799874,23466,776408,639.353424388736,1251067046
"2367","Pennsylvania Montour County",18267,9822,8445,54.1523252705204,337326235
"2368","Pennsylvania Northampton County",297735,38016,259719,310.968528823458,957444154
"2369","Pennsylvania Northumberland County",94528,32953,61575,79.6248847822787,1187166553
"2370","Pennsylvania Perry County",45969,40682,5287,32.1858552561655,1428236088
"2371","Pennsylvania Philadelphia County",1526006,0,1526006,4393.64574333167,347321129
"2372","Pennsylvania Pike County",57369,40595,16774,40.6456842080719,1411441365
"2373","Pennsylvania Potter County",17457,17457,0,6.23327531883513,2800614301
"2374","Pennsylvania Schuylkill County",148289,54068,94221,73.5322720310776,2016651953
"2375","Pennsylvania Snyder County",39702,26529,13173,46.6345387873362,851343254
"2376","Pennsylvania Somerset County",77742,55043,22699,27.9384591465119,2782615877
"2377","Pennsylvania Sullivan County",6428,6428,0,5.51599463172213,1165338335
"2378","Pennsylvania Susquehanna County",43356,36432,6924,20.3292939560155,2132685970
"2379","Pennsylvania Tioga County",41981,37829,4152,14.2962861097319,2936496911
"2380","Pennsylvania Union County",44947,19244,25703,54.9212547280505,818389897
"2381","Pennsylvania Venango County",54984,30107,24877,31.4844244775871,1746387330
"2382","Pennsylvania Warren County",41815,23016,18799,18.2606338988111,2289898600
"2383","Pennsylvania Washington County",207820,64060,143760,93.6298585155658,2219591093
"2384","Pennsylvania Wayne County",52822,46533,6289,28.1072014025177,1879304853
"2385","Pennsylvania Westmoreland County",365169,92620,272549,137.211753949118,2661353634
"2386","Pennsylvania Wyoming County",28276,23598,4678,27.4774204860775,1029063118
"2387","Pennsylvania York County",434972,107527,327445,185.741066328465,2341819225
"2388","Rhode Island Bristol County",49875,570,49305,796.916970710797,62584939
"2389","Rhode Island Kent County",166158,13270,152888,380.67307681932,436484769
"2390","Rhode Island Newport County",82888,10023,72865,312.574448694308,265178425
"2391","Rhode Island Providence County",626667,34522,592145,590.85828699488,1060604571
"2392","Rhode Island Washington County",126979,39139,87840,148.911636525153,852713750
"2393","South Carolina Abbeville County",25417,19972,5445,20.0079101028958,1270347571
"2394","South Carolina Aiken County",160099,59235,100864,57.7148562119249,2773965154
"2395","South Carolina Allendale County",10419,7112,3307,9.85762205694811,1056948617
"2396","South Carolina Anderson County",187126,70969,116157,100.988415249993,1852945207
"2397","South Carolina Bamberg County",15987,8714,7273,15.6916465561273,1018822336
"2398","South Carolina Barnwell County",22621,18672,3949,15.9265750041266,1420330485
"2399","South Carolina Beaufort County",162233,31873,130360,108.694509986379,1492559284
"2400","South Carolina Berkeley County",177843,51492,126351,62.4881993760507,2846025358
"2401","South Carolina Calhoun County",15175,15175,0,15.3721190810266,987176844
"2402","South Carolina Charleston County",350209,38106,312103,147.60188802695,2372659352
"2403","South Carolina Cherokee County",55342,33786,21556,54.4178915281822,1016981703
"2404","South Carolina Chester County",33140,23789,9351,22.0361131426156,1503894983
"2405","South Carolina Chesterfield County",46734,34474,12260,22.5812197428343,2069595909
"2406","South Carolina Clarendon County",34971,29973,4998,22.2467762836517,1571958092
"2407","South Carolina Colleton County",38892,29390,9502,14.2133587491616,2736299047
"2408","South Carolina Darlington County",68681,39673,29008,47.2560372673518,1453380435
"2409","South Carolina Dillon County",32062,22285,9777,30.5755911780827,1048614230
"2410","South Carolina Dorchester County",136555,26605,109950,91.9769175689502,1484665975
"2411","South Carolina Edgefield County",26985,19783,7202,20.8210160807231,1296046259
"2412","South Carolina Fairfield County",23956,18761,5195,13.4777389003484,1777449480
"2413","South Carolina Florence County",136885,52726,84159,66.0674464227097,2071897847
"2414","South Carolina Georgetown County",60158,24976,35182,28.5504625793093,2107076193
"2415","South Carolina Greenville County",451225,56880,394345,221.901073731163,2033451179
"2416","South Carolina Greenwood County",69661,27692,41969,59.1482814905409,1177734978
"2417","South Carolina Hampton County",21090,16550,4540,14.5435936174538,1450123027
"2418","South Carolina Horry County",269291,81799,187492,91.696087279423,2936777435
"2419","South Carolina Jasper County",24777,16519,8258,14.5981852944425,1697265756
"2420","South Carolina Kershaw County",61697,35587,26110,32.7863779326804,1881787617
"2421","South Carolina Lancaster County",76652,38291,38361,53.8923281581594,1422317473
"2422","South Carolina Laurens County",66537,42713,23824,35.9904064073938,1848742669
"2423","South Carolina Lee County",19220,13829,5391,18.0915819883128,1062372545
"2424","South Carolina Lexington County",262391,66322,196069,144.953363100133,1810175317
"2425","South Carolina Marion County",33062,20086,12976,26.0927983293386,1267092919
"2426","South Carolina Marlboro County",28933,15927,13006,23.2889250540369,1242350170
"2427","South Carolina McCormick County",10233,10233,0,11.0015487209009,930141770
"2428","South Carolina Newberry County",37508,25449,12059,22.9858251255314,1631788278
"2429","South Carolina Oconee County",74273,48219,26054,45.7854432312776,1622196811
"2430","South Carolina Orangeburg County",92501,58995,33506,32.288953906806,2864787762
"2431","South Carolina Pickens County",119224,42673,76551,92.7317104817841,1285687489
"2432","South Carolina Richland County",384504,34876,349628,196.095702254729,1960797690
"2433","South Carolina Saluda County",19875,16005,3870,16.9482039488144,1172690632
"2434","South Carolina Spartanburg County",284307,77992,206315,135.86832594214,2092518606
"2435","South Carolina Sumter County",107456,34349,73107,62.3832928624508,1722512472
"2436","South Carolina Union County",28961,18928,10033,21.7474459794486,1331696606
"2437","South Carolina Williamsburg County",34423,28205,6218,14.227555026556,2419459980
"2438","South Carolina York County",226073,51895,174178,128.251457648079,1762732402
"2439","South Dakota Aurora County",2710,2710,0,1.476991368778,1834810993
"2440","South Dakota Beadle County",17398,4761,12637,5.33673976387485,3260042792
"2441","South Dakota Bennett County",3431,3431,0,1.11817912538214,3068381373
"2442","South Dakota Bon Homme County",7070,7070,0,4.84253538643007,1459979006
"2443","South Dakota Brookings County",31965,9483,22482,15.5789686543299,2051804629
"2444","South Dakota Brown County",36531,10554,25977,8.23400520500971,4436601519
"2445","South Dakota Brule County",5255,5255,0,2.48270632053706,2116641810
"2446","South Dakota Buffalo County",1912,1912,0,1.56608328450729,1220880153
"2447","South Dakota Butte County",10110,4870,5240,1.73496401893301,5827210184
"2448","South Dakota Campbell County",1466,1466,0,0.771491955965708,1900214239
"2449","South Dakota Charles Mix County",9129,9129,0,3.21163541434705,2842477063
"2450","South Dakota Clark County",3691,3691,0,1.48819745075091,2480181644
"2451","South Dakota Clay County",13864,3372,10492,12.9866927989201,1067554320
"2452","South Dakota Codington County",27227,6116,21111,15.2686683393811,1783194146
"2453","South Dakota Corson County",4050,4050,0,0.63316150158762,6396472290
"2454","South Dakota Custer County",8216,8216,0,2.03738739227401,4032615511
"2455","South Dakota Davison County",19504,4549,14955,17.2895046730125,1128083214
"2456","South Dakota Day County",5710,5710,0,2.14486995198025,2662166065
"2457","South Dakota Deuel County",4364,4364,0,2.70593734254261,1612749834
"2458","South Dakota Dewey County",5301,3397,1904,0.888917497614815,5963433068
"2459","South Dakota Douglas County",3002,3002,0,2.68428331224047,1118361831
"2460","South Dakota Edmunds County",4071,4071,0,1.39598869674228,2916212724
"2461","South Dakota Fall River County",7094,3544,3550,1.57421977420105,4506359351
"2462","South Dakota Faulk County",2364,2364,0,0.929712726790323,2542720920
"2463","South Dakota Grant County",7356,4073,3283,4.16778125494589,1764967869
"2464","South Dakota Gregory County",4271,4271,0,1.62474115136392,2628726426
"2465","South Dakota Haakon County",1937,1937,0,0.413071552945128,4689260217
"2466","South Dakota Hamlin County",5903,5903,0,4.49334060356807,1313721910
"2467","South Dakota Hand County",3431,3431,0,0.922110731966376,3720811266
"2468","South Dakota Hanson County",3331,3331,0,2.9598807692849,1125383169
"2469","South Dakota Harding County",1255,1255,0,0.181389071668811,6918829169
"2470","South Dakota Hughes County",17022,4302,12720,8.86271215886509,1920631032
"2471","South Dakota Hutchinson County",7343,7343,0,3.48767708762938,2105412805
"2472","South Dakota Hyde County",1420,1420,0,0.637129036402631,2228747897
"2473","South Dakota Jackson County",3031,3031,0,0.627859375765757,4827514117
"2474","South Dakota Jerauld County",2071,2071,0,1.51951245453122,1362937167
"2475","South Dakota Jones County",1006,1006,0,0.400564865424299,2511453417
"2476","South Dakota Kingsbury County",5148,5148,0,2.38832964930005,2155481343
"2477","South Dakota Lake County",11200,5026,6174,7.67711536645421,1458881294
"2478","South Dakota Lawrence County",24097,8888,15209,11.629368752541,2072081513
"2479","South Dakota Lincoln County",44828,13119,31709,29.9823859167808,1495144520
"2480","South Dakota Lyman County",3755,3755,0,0.882990263104115,4252595025
"2481","South Dakota Marshall County",4656,4656,0,2.14504677872958,2170582034
"2482","South Dakota McCook County",5618,5618,0,3.77761400705599,1487182118
"2483","South Dakota McPherson County",2459,2459,0,0.835288311926722,2943893701
"2484","South Dakota Meade County",25434,9664,15770,2.82920437794031,8989806533
"2485","South Dakota Mellette County",2048,2048,0,0.604860123212494,3385906793
"2486","South Dakota Miner County",2389,2389,0,1.61735972678187,1477098731
"2487","South Dakota Minnehaha County",169468,23109,146359,81.0657132832112,2090501559
"2488","South Dakota Moody County",6486,6486,0,4.82157242690008,1345204308
"2489","South Dakota Pennington County",100948,20999,79949,14.0376351520941,7191239757
"2490","South Dakota Perkins County",2982,2982,0,0.40110271513546,7434504648
"2491","South Dakota Potter County",2329,2329,0,1.04423486728872,2230341155
"2492","South Dakota Roberts County",10149,10149,0,3.55894946602136,2851684211
"2493","South Dakota Sanborn County",2355,2355,0,1.59711529320577,1474533498
"2494","South Dakota Spink County",6415,6415,0,1.64692068244121,3895148120
"2495","South Dakota Stanley County",2966,1261,1705,0.792822947334591,3741062251
"2496","South Dakota Sully County",1373,1373,0,0.526528715207572,2607645054
"2497","South Dakota Todd County",9612,9612,0,2.67271554209655,3596342315
"2498","South Dakota Tripp County",5644,2737,2907,1.35146279001625,4176215610
"2499","South Dakota Turner County",8347,8347,0,5.22284921156342,1598169823
"2500","South Dakota Union County",14399,8840,5559,12.0716183268538,1192797818
"2501","South Dakota Walworth County",5438,1981,3457,2.96293310802067,1835343493
"2502","South Dakota Yankton County",22438,7801,14637,16.6231121569808,1349807412
"2503","South Dakota Ziebach County",2801,2060,741,0.551413747866185,5079670231
"2504","Tennessee Anderson County",75129,26041,49088,86.0342456904995,873245292
"2505","Tennessee Bedford County",45058,25053,20005,36.7307639801714,1226710123
"2506","Tennessee Benton County",16489,12937,3552,16.1526598511213,1020822586
"2507","Tennessee Bledsoe County",12876,12876,0,12.2321508328697,1052635810
"2508","Tennessee Blount County",123010,40140,82870,85.0079095640897,1447041818
"2509","Tennessee Bradley County",98963,32630,66333,116.223456521393,851489045
"2510","Tennessee Campbell County",40716,22403,18313,32.7380742392278,1243689525
"2511","Tennessee Cannon County",13801,11197,2604,20.0598349367013,687991703
"2512","Tennessee Carroll County",28522,23690,4832,18.3769155493343,1552055889
"2513","Tennessee Carter County",57424,23524,33900,64.9804840603384,883711484
"2514","Tennessee Cheatham County",39105,32442,6663,49.9228741064723,783308267
"2515","Tennessee Chester County",17131,11177,5954,23.1483720125343,740052043
"2516","Tennessee Claiborne County",32213,23050,9163,28.619634564928,1125555951
"2517","Tennessee Clay County",7861,7861,0,12.8316331381338,612626617
"2518","Tennessee Cocke County",35662,24083,11579,31.6849392508326,1125518964
"2519","Tennessee Coffee County",52796,24967,27829,47.5214377571209,1110993322
"2520","Tennessee Crockett County",14586,9828,4758,21.2088641966617,687731312
"2521","Tennessee Cumberland County",56053,34132,21921,31.7788229031018,1763847584
"2522","Tennessee Davidson County",626681,21382,605299,480.054003246814,1305438546
"2523","Tennessee Decatur County",11757,11757,0,13.5973458082757,864654041
"2524","Tennessee DeKalb County",18723,14673,4050,23.752499156693,788253896
"2525","Tennessee Dickson County",49666,33650,16016,39.1433185945096,1268824458
"2526","Tennessee Dyer County",38335,16432,21903,28.8902031450639,1326920403
"2527","Tennessee Fayette County",38413,30363,8050,21.0437606797476,1825386659
"2528","Tennessee Fentress County",17959,17959,0,13.9066228960815,1291399079
"2529","Tennessee Franklin County",41052,28579,12473,28.5826186660395,1436257485
"2530","Tennessee Gibson County",49683,23706,25977,31.8257413525812,1561094821
"2531","Tennessee Giles County",29485,21744,7741,18.6343507306265,1582292854
"2532","Tennessee Grainger County",22657,22657,0,31.1757139149391,726751601
"2533","Tennessee Greene County",68831,44874,23957,42.7150393945627,1611399661
"2534","Tennessee Grundy County",13703,13703,0,14.674780613422,933778866
"2535","Tennessee Hamblen County",62544,13680,48864,149.823576055775,417450989
"2536","Tennessee Hamilton County",336463,33721,302742,239.494163908259,1404890184
"2537","Tennessee Hancock County",6819,6819,0,11.8414585098225,575858117
"2538","Tennessee Hardeman County",27253,21859,5394,15.7576407891259,1729510170
"2539","Tennessee Hardin County",26026,17679,8347,17.405820466772,1495246952
"2540","Tennessee Hawkins County",56833,32884,23949,45.0605145672113,1261259454
"2541","Tennessee Haywood County",18787,8908,9879,13.6063430260963,1380753077
"2542","Tennessee Henderson County",27769,21209,6560,20.6157028698872,1346982937
"2543","Tennessee Henry County",32330,21612,10718,22.2073687385044,1455823082
"2544","Tennessee Hickman County",24690,24690,0,15.5638795940831,1586365395
"2545","Tennessee Houston County",8426,8426,0,16.2432190608736,518739541
"2546","Tennessee Humphreys County",18538,15292,3246,13.4799069098774,1375232049
"2547","Tennessee Jackson County",11638,11638,0,14.5739936440432,798545703
"2548","Tennessee Jefferson County",51407,30581,20826,72.4186531877897,709858548
"2549","Tennessee Johnson County",18244,15546,2698,23.6001431930021,773046157
"2550","Tennessee Knox County",432226,47205,385021,328.371525767591,1316271254
"2551","Tennessee Lake County",7832,7832,0,18.2402903466687,429379130
"2552","Tennessee Lauderdale County",27815,16317,11498,22.7534159720168,1222453808
"2553","Tennessee Lawrence County",41869,31769,10100,26.1950513844753,1598355330
"2554","Tennessee Lewis County",12161,8536,3625,16.6450383594086,730608109
"2555","Tennessee Lincoln County",33361,24183,9178,22.5844086688995,1477169515
"2556","Tennessee Loudon County",48556,19720,28836,81.7901765429742,593665426
"2557","Tennessee Macon County",22248,17703,4545,27.9673731076611,795498380
"2558","Tennessee Madison County",98294,25386,72908,68.1212794878384,1442926509
"2559","Tennessee Marion County",28237,21747,6490,21.8852917091749,1290227262
"2560","Tennessee Marshall County",30617,20153,10464,31.4848118710301,972437127
"2561","Tennessee Maury County",80956,33672,47284,50.9791666830655,1588021250
"2562","Tennessee McMinn County",52266,31538,20728,46.9166424502041,1114018337
"2563","Tennessee McNairy County",26075,22235,3840,17.8865177816661,1457801922
"2564","Tennessee Meigs County",11753,11753,0,23.2565591698887,505362806
"2565","Tennessee Monroe County",44519,33868,10651,27.0450598855075,1646104693
"2566","Tennessee Montgomery County",172331,34022,138309,123.40547294375,1396461566
"2567","Tennessee Moore County",6362,6354,8,19.0089211627822,334684959
"2568","Tennessee Morgan County",21987,21962,25,16.2572783244275,1352440400
"2569","Tennessee Obion County",31807,19588,12219,22.5447342526745,1410839429
"2570","Tennessee Overton County",22083,18598,3485,19.669290106221,1122714642
"2571","Tennessee Perry County",7915,7915,0,7.36862751433746,1074148474
"2572","Tennessee Pickett County",5077,5077,0,12.0275741174499,422113383
"2573","Tennessee Polk County",16825,16825,0,14.9448428796306,1125806416
"2574","Tennessee Putnam County",72321,25295,47026,69.6162295250004,1038852585
"2575","Tennessee Rhea County",31809,21635,10174,38.9423431486304,816822960
"2576","Tennessee Roane County",54181,27628,26553,57.9953703550676,934229744
"2577","Tennessee Robertson County",66283,35289,30994,53.7323356405752,1233577495
"2578","Tennessee Rutherford County",262604,44699,217905,163.703362186686,1604145428
"2579","Tennessee Scott County",22228,17906,4322,16.1231032385454,1378642788
"2580","Tennessee Sequatchie County",14112,10415,3697,20.4947153282952,688567749
"2581","Tennessee Sevier County",89889,50920,38969,58.576116976935,1534567408
"2582","Tennessee Shelby County",927644,25601,902043,469.310005610862,1976612450
"2583","Tennessee Smith County",19166,15884,3282,23.545324583362,814004493
"2584","Tennessee Stewart County",13324,13324,0,11.1998392777673,1189659929
"2585","Tennessee Sullivan County",156823,40086,116737,146.480689739844,1070605281
"2586","Tennessee Sumner County",160645,44792,115853,117.150723497002,1371267673
"2587","Tennessee Tipton County",61081,33671,27410,51.4512838647345,1187161824
"2588","Tennessee Trousdale County",7870,7870,0,26.6095221711874,295758787
"2589","Tennessee Unicoi County",18313,8180,10133,37.980758304495,482165202
"2590","Tennessee Union County",19109,19109,0,33.0040139316283,578990181
"2591","Tennessee Van Buren County",5548,5548,0,7.8345815932027,708142475
"2592","Tennessee Warren County",39839,24453,15386,35.5503567604435,1120635730
"2593","Tennessee Washington County",122979,32493,90486,145.444345882306,845539916
"2594","Tennessee Wayne County",17021,17021,0,8.95224587352706,1901310603
"2595","Tennessee Weakley County",35021,23466,11555,23.2986321249405,1503135455
"2596","Tennessee White County",25841,20201,5640,26.4878608171639,975578971
"2597","Tennessee Williamson County",183182,35512,147670,121.398973587325,1508925443
"2598","Tennessee Wilson County",113993,43850,70143,77.1039214361276,1478433235
"2599","Texas Anderson County",58458,39204,19254,21.2410310188908,2752126295
"2600","Texas Andrews County",14786,2440,12346,3.80412858962755,3886829704
"2601","Texas Angelina County",86771,37383,49388,41.9947329638798,2066235308
"2602","Texas Aransas County",23158,6313,16845,35.4711363002368,652868851
"2603","Texas Archer County",9054,8057,997,3.87081282667561,2339043608
"2604","Texas Armstrong County",1901,1901,0,0.80736202692286,2354581881
"2605","Texas Atascosa County",44911,27266,17645,14.2186191665262,3158604888
"2606","Texas Austin County",28417,18853,9564,16.9709568425593,1674448899
"2607","Texas Bailey County",7165,2060,5105,3.34594998375617,2141394831
"2608","Texas Bandera County",20485,20485,0,9.99961502580473,2048578865
"2609","Texas Bastrop County",74171,47360,26811,32.2440717898541,2300298811
"2610","Texas Baylor County",3726,3726,0,1.65838307805669,2246766775
"2611","Texas Bee County",31861,13693,18168,13.9752905406144,2279809490
"2612","Texas Bell County",310235,47113,263122,113.9682274252,2722118322
"2613","Texas Bexar County",1714773,77835,1636938,534.01087753749,3211119983
"2614","Texas Blanco County",10497,10497,0,5.71435806084755,1836951743
"2615","Texas Borden County",641,641,0,0.275774203260244,2324365341
"2616","Texas Bosque County",18212,14791,3421,7.15345583520136,2545902347
"2617","Texas Bowie County",92565,32791,59774,40.3834167235801,2292153748
"2618","Texas Brazoria County",313166,70552,242614,89.0579444009541,3516429692
"2619","Texas Brazos County",194851,23506,171345,128.504579465211,1516296157
"2620","Texas Brewster County",9232,3219,6013,0.576430951507769,16015795085
"2621","Texas Briscoe County",1637,1637,0,0.702276415573316,2330990994
"2622","Texas Brooks County",7223,2294,4929,2.95624535534277,2443301936
"2623","Texas Brown County",38106,15395,22711,15.5784523674187,2446070964
"2624","Texas Burleson County",17187,13175,4012,10.0693043673952,1706870641
"2625","Texas Burnet County",42750,23800,18950,16.6011901359424,2575116582
"2626","Texas Caldwell County",38066,16099,21967,26.9549522388709,1412208030
"2627","Texas Calhoun County",21381,9564,11817,16.2876720796345,1312710613
"2628","Texas Callahan County",13544,9776,3768,5.81446453730603,2329363248
"2629","Texas Cameron County",406220,34207,372013,176.045004241613,2307478146
"2630","Texas Camp County",12401,7624,4777,24.4504934468813,507188128
"2631","Texas Carson County",6182,5885,297,2.5938176185874,2383359553
"2632","Texas Cass County",30464,22547,7917,12.5535518609989,2426723555
"2633","Texas Castro County",8062,3689,4373,3.48014115252219,2316572704
"2634","Texas Chambers County",35096,16046,19050,22.6926680191366,1546578832
"2635","Texas Cherokee County",50845,32057,18788,18.644820162655,2727030862
"2636","Texas Childress County",7041,2334,4707,3.90368531745202,1803680222
"2637","Texas Clay County",10752,8021,2731,3.81307094497984,2819774443
"2638","Texas Cochran County",3127,3127,0,1.55755806085075,2007629814
"2639","Texas Coke County",3320,3320,0,1.40636510034041,2360695668
"2640","Texas Coleman County",8895,4585,4310,2.72149476733382,3268424436
"2641","Texas Collin County",782341,41016,741325,359.0759494397,2178761906
"2642","Texas Collingsworth County",3057,3057,0,1.28512840967126,2378750619
"2643","Texas Colorado County",20874,13070,7804,8.39291695563021,2487097169
"2644","Texas Comal County",108472,50055,58417,74.8579886393147,1449037063
"2645","Texas Comanche County",13974,9986,3988,5.75352779714352,2428770746
"2646","Texas Concho County",4087,4087,0,1.60398528940076,2548028356
"2647","Texas Cooke County",38437,22691,15746,16.9653655925719,2265615780
"2648","Texas Coryell County",75388,14643,60745,27.6669568830915,2724838887
"2649","Texas Cottle County",1505,1505,0,0.645244737457449,2332448314
"2650","Texas Crane County",4375,468,3907,2.15165467462549,2033318846
"2651","Texas Crockett County",3719,846,2873,0.511487905511368,7270944161
"2652","Texas Crosby County",6059,6059,0,2.59875460842368,2331501397
"2653","Texas Culberson County",2398,2398,0,0.242832982568128,9875100057
"2654","Texas Dallam County",6703,1578,5125,1.72162104412252,3893423598
"2655","Texas Dallas County",2368139,16300,2351839,1049.42664289212,2256602704
"2656","Texas Dawson County",13833,2254,11579,5.93237404170443,2331781493
"2657","Texas Deaf Smith County",19372,3431,15941,4.99681518290929,3876869424
"2658","Texas Delta County",5231,5231,0,7.86410877761544,665173912
"2659","Texas Denton County",662614,45759,616855,291.242357124812,2275129231
"2660","Texas DeWitt County",20097,9973,10124,8.53652977843978,2354235330
"2661","Texas Dickens County",2444,2444,0,1.04647711757271,2335454793
"2662","Texas Dimmit County",9996,3946,6050,2.90429914788168,3441794213
"2663","Texas Donley County",3677,3677,0,1.53168550865617,2400623352
"2664","Texas Duval County",11782,7899,3883,2.53643934782563,4645094317
"2665","Texas Eastland County",18583,11214,7369,7.74420953340748,2399599329
"2666","Texas Ector County",137130,12966,124164,58.9806696921753,2324999033
"2667","Texas Edwards County",2002,2002,0,0.364980414437226,5485225839
"2668","Texas El Paso County",800647,17409,783238,305.256900188613,2622862905
"2669","Texas Ellis County",149610,47838,101772,61.7483126263422,2422900216
"2670","Texas Erath County",37890,17551,20339,13.5073399559083,2805141510
"2671","Texas Falls County",17866,12034,5832,9.01144107559532,1982590781
"2672","Texas Fannin County",33915,23920,9995,14.6992766208372,2307256396
"2673","Texas Fayette County",24554,16485,8069,9.97923328624837,2460509670
"2674","Texas Fisher County",3974,3974,0,1.70686451721576,2328245716
"2675","Texas Floyd County",6446,3437,3009,2.50852520988895,2569637321
"2676","Texas Foard County",1336,1336,0,0.732304167964862,1824378528
"2677","Texas Fort Bend County",585375,32405,552970,262.355865569852,2231225129
"2678","Texas Franklin County",10605,7331,3274,14.3978369439196,736568975
"2679","Texas Freestone County",19816,13173,6643,8.7167164793773,2273333089
"2680","Texas Frio County",17217,3819,13398,5.86459907465497,2935750557
"2681","Texas Gaines County",17526,11049,6477,4.50408632229311,3891133239
"2682","Texas Galveston County",291309,17915,273394,297.271288483509,979943275
"2683","Texas Garza County",6461,1443,5018,2.79222308453412,2313926862
"2684","Texas Gillespie County",24837,13326,11511,9.06208265133761,2740760701
"2685","Texas Glasscock County",1226,1226,0,0.525829773235593,2331553028
"2686","Texas Goliad County",7210,7210,0,3.26731242781134,2206706631
"2687","Texas Gonzales County",19807,12930,6877,7.16941411631817,2762708316
"2688","Texas Gray County",22535,4369,18166,9.39638974919401,2398261524
"2689","Texas Grayson County",120877,52159,68718,50.032895810477,2415950507
"2690","Texas Gregg County",121730,16266,105464,171.9713112805,707850624
"2691","Texas Grimes County",26604,18331,8273,13.044309368408,2039510046
"2692","Texas Guadalupe County",131533,34412,97121,71.3977259276323,1842257555
"2693","Texas Hale County",36273,8379,27894,13.9398104915718,2602115719
"2694","Texas Hall County",3353,3353,0,1.46532245236477,2288233552
"2695","Texas Hamilton County",8517,5483,3034,3.93393492958186,2165007849
"2696","Texas Hansford County",5613,2264,3349,2.35612968629756,2382296710
"2697","Texas Hardeman County",4139,4139,0,2.29901397068242,1800337037
"2698","Texas Hardin County",54635,28163,26472,23.6868004450217,2306558884
"2699","Texas Harris County",4092459,49653,4042806,927.577390352091,4411986582
"2700","Texas Harrison County",65631,36789,28842,28.1573964387693,2330861809
"2701","Texas Hartley County",6062,3471,2591,1.60088820129535,3786647934
"2702","Texas Haskell County",5899,2809,3090,2.52191106251191,2339099141
"2703","Texas Hays County",157107,49822,107285,89.4709745408314,1755954943
"2704","Texas Hemphill County",3807,1026,2781,1.62188395555689,2347270276
"2705","Texas Henderson County",78532,47206,31326,34.7026502800939,2262997188
"2706","Texas Hidalgo County",774769,39813,734956,190.430098246927,4068521768
"2707","Texas Hill County",35089,26761,8328,14.129161732176,2483445279
"2708","Texas Hockley County",22935,9139,13796,9.74827528368581,2352723875
"2709","Texas Hood County",51182,16811,34371,46.9794064144565,1089456081
"2710","Texas Hopkins County",35161,20965,14196,17.6957703542623,1986971988
"2711","Texas Houston County",23732,17440,6292,7.44407185799703,3188040155
"2712","Texas Howard County",35012,7025,27987,15.0070401264786,2333038341
"2713","Texas Hudspeth County",3476,3476,0,0.293611038309553,11838791961
"2714","Texas Hunt County",86129,48776,37353,39.5738049569425,2176414426
"2715","Texas Hutchinson County",22150,4998,17152,9.63712176771061,2298404081
"2716","Texas Irion County",1599,1599,0,0.58710469695048,2723534675
"2717","Texas Jack County",9044,4813,4231,3.83447288922584,2358603193
"2718","Texas Jackson County",14075,8701,5374,6.551919396285,2148225451
"2719","Texas Jasper County",35710,27920,7790,14.6858174771263,2431597700
"2720","Texas Jeff Davis County",2342,2342,0,0.399306334719612,5865171164
"2721","Texas Jefferson County",252273,21196,231077,111.153374965478,2269593704
"2722","Texas Jim Hogg County",5300,922,4378,1.80113795005311,2942584159
"2723","Texas Jim Wells County",40838,16370,24468,18.2292046669603,2240251330
"2724","Texas Johnson County",150934,57165,93769,80.4147839030285,1876943426
"2725","Texas Jones County",20202,17202,3000,8.40019390651348,2404944484
"2726","Texas Karnes County",14824,5691,9133,7.65639033331551,1936160430
"2727","Texas Kaufman County",103350,50453,52897,51.1127409126899,2022000741
"2728","Texas Kendall County",33410,19431,13979,19.4725834511115,1715745632
"2729","Texas Kenedy County",416,416,0,0.110138749397015,3777053964
"2730","Texas Kent County",808,808,0,0.34567113219737,2337481857
"2731","Texas Kerr County",49625,20397,29228,17.3660887580408,2857580696
"2732","Texas Kimble County",4607,2041,2566,1.42189563188656,3240040898
"2733","Texas King County",286,286,0,0.121230269992388,2359146771
"2734","Texas Kinney County",3598,736,2862,1.02142611697844,3522525947
"2735","Texas Kleberg County",32061,6050,26011,14.0459604055981,2282577985
"2736","Texas Knox County",3719,3719,0,1.68807818408323,2203097010
"2737","Texas La Salle County",6886,3192,3694,1.78833421184451,3850510690
"2738","Texas Lamar County",49793,23444,26349,21.1920096735598,2349611989
"2739","Texas Lamb County",13977,8063,5914,5.31061696617511,2631897591
"2740","Texas Lampasas County",19677,13433,6244,10.6578369231162,1846247052
"2741","Texas Lavaca County",19263,15664,3599,7.66982010771594,2511532178
"2742","Texas Lee County",16612,11582,5030,10.196773257006,1629142826
"2743","Texas Leon County",16801,16801,0,6.04472698029791,2779447286
"2744","Texas Liberty County",75643,47827,27816,25.2119390395225,3000284900
"2745","Texas Limestone County",23384,12538,10846,9.97319741579203,2344684360
"2746","Texas Lipscomb County",3302,3302,0,1.36766562510245,2414332816
"2747","Texas Live Oak County",11531,11531,0,4.28215834676988,2692800935
"2748","Texas Llano County",19301,8720,10581,7.9784620299335,2419137915
"2749","Texas Loving County",82,82,0,0.047330233231147,1732507837
"2750","Texas Lubbock County",278831,31607,247224,120.206955550437,2319591231
"2751","Texas Lynn County",5915,3355,2560,2.5606892708136,2309924936
"2752","Texas Madison County",13664,9210,4454,11.3196648816194,1207102873
"2753","Texas Marion County",10546,10546,0,10.6905845000439,986475529
"2754","Texas Martin County",4799,4799,0,2.02515589574337,2369694111
"2755","Texas Mason County",4012,4012,0,1.66778285417521,2405588947
"2756","Texas Matagorda County",36702,13366,23336,12.8792474374219,2849700666
"2757","Texas Maverick County",54258,5022,49236,16.3759958490626,3313264152
"2758","Texas McCulloch County",8283,2926,5357,3.00120989956292,2759886938
"2759","Texas McLennan County",234906,54855,180051,87.4530925357767,2686079968
"2760","Texas McMullen County",707,707,0,0.239571671983121,2951100162
"2761","Texas Medina County",46006,28319,17687,13.402449155157,3432656186
"2762","Texas Menard County",2242,2242,0,0.959659237794409,2336245942
"2763","Texas Midland County",136872,16824,120048,58.6988867597362,2331764835
"2764","Texas Milam County",24757,13909,10848,9.39959299576288,2633837445
"2765","Texas Mills County",4936,4936,0,2.54697207322109,1937987484
"2766","Texas Mitchell County",9403,3455,5948,3.98480890325324,2359711652
"2767","Texas Montague County",19719,11623,8096,8.17864604401483,2411034772
"2768","Texas Montgomery County",455746,103571,352175,168.914889402851,2698080682
"2769","Texas Moore County",21904,3683,18221,9.40009676761047,2330188778
"2770","Texas Morris County",12934,10143,2791,19.8180579395097,652637107
"2771","Texas Motley County",1210,1210,0,0.472111324724361,2562954830
"2772","Texas Nacogdoches County",64524,29978,34546,26.319995800418,2451520148
"2773","Texas Navarro County",47735,25136,22599,18.2548416437689,2614922711
"2774","Texas Newton County",14445,14445,0,5.97342065504744,2418212417
"2775","Texas Nolan County",15216,4969,10247,6.44183043438242,2362061553
"2776","Texas Nueces County",340223,21935,318288,156.665066511652,2171658351
"2777","Texas Ochiltree County",10223,1422,8801,4.301446416793,2376642415
"2778","Texas Oldham County",2052,2052,0,0.528000045969969,3886363298
"2779","Texas Orange County",81837,28783,53054,94.6970699607366,864197805
"2780","Texas Palo Pinto County",28111,14116,13995,11.4034697593123,2465126895
"2781","Texas Panola County",23796,17304,6492,11.4595494832995,2076521423
"2782","Texas Parker County",116927,65578,51349,49.9688486256635,2339997883
"2783","Texas Parmer County",10269,6163,4106,4.50156944792452,2281204393
"2784","Texas Pecos County",15507,6168,9339,1.25681754250822,12338306457
"2785","Texas Polk County",45413,35258,10155,16.5870528732266,2737858277
"2786","Texas Potter County",121073,10892,110181,51.4620260305981,2352666798
"2787","Texas Presidio County",7818,3164,4654,0.782973157024799,9985016638
"2788","Texas Rains County",10914,10175,739,18.3651400456942,594278071
"2789","Texas Randall County",120725,17355,103370,51.135440613214,2360887059
"2790","Texas Reagan County",3367,448,2919,1.10610458202266,3044015959
"2791","Texas Real County",3309,3309,0,1.82726197434881,1810906179
"2792","Texas Red River County",12860,9739,3121,4.7900636457321,2684724244
"2793","Texas Reeves County",13783,1998,11785,2.01931308097041,6825588429
"2794","Texas Refugio County",7383,4480,2903,3.69993430363976,1995440836
"2795","Texas Roberts County",929,929,0,0.388167208586461,2393298505
"2796","Texas Robertson County",16622,12276,4346,7.50019468604862,2216209138
"2797","Texas Rockwall County",78337,12562,65775,238.091441112509,329020647
"2798","Texas Runnels County",10501,4280,6221,3.85791876318997,2721933935
"2799","Texas Rusk County",53330,35130,18200,22.2838066373819,2393217679
"2800","Texas Sabine County",10834,10834,0,8.51264729721236,1272694571
"2801","Texas San Augustine County",8865,8865,0,6.45010817136992,1374395555
"2802","Texas San Jacinto County",26384,26384,0,17.895567182343,1474331589
"2803","Texas San Patricio County",64804,12734,52070,36.0818239175579,1796028941
"2804","Texas San Saba County",6131,3026,3105,2.0850871374154,2940404691
"2805","Texas Schleicher County",3461,3461,0,1.01958538745518,3394517068
"2806","Texas Scurry County",16921,5364,11557,7.21550620086109,2345088415
"2807","Texas Shackelford County",3378,3378,0,1.42652630830793,2367989977
"2808","Texas Shelby County",25448,20214,5234,12.350091944634,2060551461
"2809","Texas Sherman County",3034,3034,0,1.26911061185101,2390650564
"2810","Texas Smith County",209714,66286,143428,87.8730814198793,2386555662
"2811","Texas Somervell County",8490,8490,0,17.5799297284861,482937084
"2812","Texas Starr County",60968,14453,46515,19.2448366623749,3168018574
"2813","Texas Stephens County",9630,3791,5839,4.14640696736117,2322492721
"2814","Texas Sterling County",1143,1143,0,0.477897187351532,2391727824
"2815","Texas Stonewall County",1490,1490,0,0.627833522505262,2373240591
"2816","Texas Sutton County",4128,776,3352,1.09622469808601,3765651337
"2817","Texas Swisher County",7854,2951,4903,3.40663348668399,2305501907
"2818","Texas Tarrant County",1809034,23304,1785730,808.783135723027,2236735560
"2819","Texas Taylor County",131506,21085,110421,55.4581025904109,2371267567
"2820","Texas Terrell County",984,984,0,0.161119761620378,6107258291
"2821","Texas Terry County",12651,3121,9530,5.49545721489241,2302083249
"2822","Texas Throckmorton County",1641,1641,0,0.694309497408758,2363499284
"2823","Texas Titus County",32334,16347,15987,30.7452239207301,1051675541
"2824","Texas Tom Green County",110224,17240,92984,27.962224019649,3941889598
"2825","Texas Travis County",1024266,55961,968305,399.384329886501,2564612388
"2826","Texas Trinity County",14585,11265,3320,8.11885559713201,1796435449
"2827","Texas Tyler County",21766,17006,4760,9.09020307827737,2394445956
"2828","Texas Upshur County",39309,31172,8137,26.0354560296933,1509825676
"2829","Texas Upton County",3355,3355,0,1.04354155424444,3215013323
"2830","Texas Uvalde County",26405,8287,18118,6.5691915977574,4019520455
"2831","Texas Val Verde County",48879,4965,43914,6.00120518034506,8144863995
"2832","Texas Van Zandt County",52579,39444,13135,24.0943663899673,2182211358
"2833","Texas Victoria County",86793,23110,63683,37.9881437573411,2284739169
"2834","Texas Walker County",67861,30933,36928,33.4128085270059,2030987606
"2835","Texas Waller County",43205,26632,16573,32.490387152513,1329777937
"2836","Texas Ward County",10658,2972,7686,4.9246831194557,2164200161
"2837","Texas Washington County",33718,18036,15682,21.5556212378979,1564232347
"2838","Texas Webb County",250304,6507,243797,28.7500894114353,8706199011
"2839","Texas Wharton County",41280,20597,20683,14.6741228387374,2813115336
"2840","Texas Wheeler County",5410,5410,0,2.28404621088036,2368603566
"2841","Texas Wichita County",131500,14027,117473,80.8766572057584,1625932680
"2842","Texas Wilbarger County",13535,2963,10572,5.38283453565886,2514474467
"2843","Texas Willacy County",22134,7653,14481,14.4711245769877,1529528675
"2844","Texas Williamson County",422679,50679,372000,145.932979265856,2896391221
"2845","Texas Wilson County",42918,36850,6068,20.6172161758303,2081658340
"2846","Texas Winkler County",7110,1289,5821,3.26377937181956,2178456075
"2847","Texas Wise County",59127,42635,16492,25.2415985278302,2342442771
"2848","Texas Wood County",41964,31137,10827,25.1108644005053,1671149162
"2849","Texas Yoakum County",7879,2941,4938,3.80401127509135,2071234660
"2850","Texas Young County",18550,6227,12323,7.83209320954622,2368460066
"2851","Texas Zapata County",14018,3299,10719,5.42098671042092,2585876105
"2852","Texas Zavala County",11677,4441,7236,3.4750215864996,3360266896
"2853","Utah Beaver County",6629,3747,2882,0.988258705836863,6707757757
"2854","Utah Box Elder County",49975,15542,34433,3.35833020477799,14880907163
"2855","Utah Cache County",112656,17673,94983,37.3422485896718,3016851000
"2856","Utah Carbon County",21403,7216,14187,5.58930250255793,3829279233
"2857","Utah Daggett County",1059,1059,0,0.586649099619105,1805167690
"2858","Utah Davis County",306479,2818,303661,396.053564057049,773832198
"2859","Utah Duchesne County",18607,12692,5915,2.21670021301978,8394008306
"2860","Utah Emery County",10976,8083,2893,0.949699449845494,11557340590
"2861","Utah Garfield County",5172,5172,0,0.385869289615759,13403502531
"2862","Utah Grand County",9225,2342,6883,0.970107764894812,9509252821
"2863","Utah Iron County",46163,10412,35751,5.40653932034797,8538363871
"2864","Utah Juab County",10246,4454,5792,1.1661790160383,8785958124
"2865","Utah Kane County",7125,3913,3212,0.689428673514967,10334644139
"2866","Utah Millard County",12503,9245,3258,0.734498419089524,17022500900
"2867","Utah Morgan County",9469,5951,3518,6.00135452644154,1577810469
"2868","Utah Piute County",1556,1556,0,0.792798005661386,1962668913
"2869","Utah Rich County",2264,2264,0,0.849685870683245,2664514120
"2870","Utah Salt Lake County",1029655,9301,1020354,535.58093868659,1922501205
"2871","Utah San Juan County",14746,11482,3264,0.728065377650154,20253675635
"2872","Utah Sanpete County",27822,11387,16435,6.75541201066642,4118475669
"2873","Utah Sevier County",20802,13462,7340,4.20380653384243,4948372346
"2874","Utah Summit County",36324,14239,22085,7.49302176145807,4847710464
"2875","Utah Tooele County",58218,10305,47913,3.23828802511968,17978017875
"2876","Utah Uintah County",32588,15267,17321,2.80874117885164,11602350635
"2877","Utah Utah County",516564,17186,499378,99.5513005781998,5188922666
"2878","Utah Wasatch County",23530,6318,17212,7.72860664512589,3044533262
"2879","Utah Washington County",138115,21012,117103,21.9780064743781,6284236933
"2880","Utah Wayne County",2778,2778,0,0.435893108436658,6373122094
"2881","Utah Weber County",231236,13414,217822,154.978630808929,1492050864
"2882","Vermont Addison County",36821,28879,7942,18.5517397001347,1984773428
"2883","Vermont Bennington County",37125,23950,13175,21.2362420955532,1748190656
"2884","Vermont Caledonia County",31227,23230,7997,18.5814263289932,1680549138
"2885","Vermont Chittenden County",156545,40680,115865,112.644085822654,1389731195
"2886","Vermont Essex County",6306,6306,0,3.66902952148456,1718710619
"2887","Vermont Franklin County",47746,34241,13505,29.0905143152056,1641291023
"2888","Vermont Grand Isle County",6970,6970,0,32.8943287057777,211890629
"2889","Vermont Lamoille County",24475,24475,0,20.5970291129653,1188278167
"2890","Vermont Orange County",28936,28137,799,16.2615950234596,1779407245
"2891","Vermont Orleans County",27231,23227,4004,15.1657723171641,1795556430
"2892","Vermont Rutland County",61642,37610,24032,25.5964477468899,2408224790
"2893","Vermont Washington County",59534,31437,28097,33.447455409967,1779926134
"2894","Vermont Windham County",44513,30378,14135,21.8852092509323,2033930747
"2895","Vermont Windsor County",56670,42836,13834,22.5725606133677,2510570288
"2896","Virginia Accomack County",33164,33164,0,28.4867764317663,1164189289
"2897","Virginia Albemarle County",98970,44559,54411,53.0215391819598,1866599905
"2898","Virginia Alexandria city",139966,0,139966,3596.27338656203,38919733
"2899","Virginia Alleghany County",16250,8514,7736,14.0847837205099,1153727336
"2900","Virginia Amelia County",12690,12690,0,13.7913406630291,920142596
"2901","Virginia Amherst County",32353,20597,11756,26.3571568325309,1227484444
"2902","Virginia Appomattox County",14973,14973,0,17.3349860472523,863744566
"2903","Virginia Arlington County",207627,0,207627,3086.30849739466,67273573
"2904","Virginia Augusta County",73750,48998,24752,29.4468116258285,2504515631
"2905","Virginia Bath County",4731,4731,0,3.45199292318248,1370512659
"2906","Virginia Bedford County",68676,53864,14812,35.2127739531548,1950314965
"2907","Virginia Bland County",6824,6824,0,7.36532617388515,926503435
"2908","Virginia Botetourt County",33148,21247,11901,23.6483115282853,1401706839
"2909","Virginia Bristol city",17835,7,17828,529.173339561764,33703512
"2910","Virginia Brunswick County",17434,13164,4270,11.8891289880553,1466381601
"2911","Virginia Buchanan County",24098,24098,0,18.5063305750335,1302149008
"2912","Virginia Buckingham County",17146,17146,0,11.4207338488651,1501304577
"2913","Virginia Buena Vista city",6650,259,6391,383.015183067434,17362236
"2914","Virginia Campbell County",54842,33516,21326,42.0242359520421,1305008854
"2915","Virginia Caroline County",28545,22380,6165,20.8929175811225,1366252458
"2916","Virginia Carroll County",30042,29184,858,24.4354942887624,1229441060
"2917","Virginia Charles City County",7256,7256,0,15.3243733184016,473494077
"2918","Virginia Charlotte County",12586,12586,0,10.2246586018298,1230945745
"2919","Virginia Charlottesville city",43475,0,43475,1639.49189214221,26517362
"2920","Virginia Chesapeake city",222209,16948,205261,251.74664650908,882669156
"2921","Virginia Chesterfield County",316236,18749,297487,288.448564805575,1096334108
"2922","Virginia Clarke County",14034,9757,4277,30.7562429568308,456297605
"2923","Virginia Colonial Heights city",17411,0,17411,893.961327431166,19476234
"2924","Virginia Covington city",5961,0,5961,420.875302012096,14163340
"2925","Virginia Craig County",5190,5190,0,6.08091786006877,853489575
"2926","Virginia Culpeper County",46689,28911,17778,47.5345991156313,982210871
"2927","Virginia Cumberland County",10052,9650,402,13.0474345857515,770419651
"2928","Virginia Danville city",43055,1944,41111,387.189795707584,111198695
"2929","Virginia Dickenson County",15903,15903,0,18.5766450507549,856074924
"2930","Virginia Dinwiddie County",28001,19939,8062,21.4629697667937,1304619086
"2931","Virginia Emporia city",5927,374,5553,331.953563241746,17854907
"2932","Virginia Essex County",11151,8617,2534,16.7446413202251,665944393
"2933","Virginia Fairfax city",22565,0,22565,1396.39523957012,16159465
"2934","Virginia Fairfax County",1081726,15079,1066647,1068.26113985188,1012604465
"2935","Virginia Falls Church city",12332,0,12332,2382.16060730801,5176813
"2936","Virginia Fauquier County",65203,37489,27714,38.8833934101033,1676885536
"2937","Virginia Floyd County",15279,15279,0,15.5072061075369,985283867
"2938","Virginia Fluvanna County",25691,16163,9528,34.6824120218304,740750095
"2939","Virginia Franklin city",8582,279,8303,403.804020197918,21252884
"2940","Virginia Franklin County",56159,50111,6048,31.4054063861012,1788195297
"2941","Virginia Frederick County",78305,35059,43246,73.1173460160155,1070949703
"2942","Virginia Fredericksburg city",24286,283,24003,898.154043070787,27039905
"2943","Virginia Galax city",7042,966,6076,329.984009692777,21340428
"2944","Virginia Giles County",17286,11458,5828,18.7591754368082,921469073
"2945","Virginia Gloucester County",36858,23820,13038,65.3375205434146,564116907
"2946","Virginia Goochland County",21717,21064,653,29.7957704296764,728861838
"2947","Virginia Grayson County",15533,15514,19,13.563242953909,1145227587
"2948","Virginia Greene County",18403,9430,8973,45.4759089080601,404675804
"2949","Virginia Greensville County",12243,10653,1590,16.0116077892027,764632769
"2950","Virginia Halifax County",36241,27935,8306,17.1093923645922,2118193284
"2951","Virginia Hampton city",137436,342,137094,1032.11132671965,133160054
"2952","Virginia Hanover County",99863,39032,60831,82.2931677343262,1213502928
"2953","Virginia Harrisonburg city",48914,0,48914,1084.2643940842,45112613
"2954","Virginia Henrico County",306935,13103,293832,507.102720915256,605271846
"2955","Virginia Henry County",54151,32881,21270,54.6846809254751,990240760
"2956","Virginia Highland County",2321,2321,0,2.15856962384806,1075249079
"2957","Virginia Hopewell city",22591,0,22591,848.631566104083,26620504
"2958","Virginia Isle of Wight County",35270,20240,15030,43.1473184214407,817432028
"2959","Virginia James City County",67009,10622,56387,181.640935903967,368909132
"2960","Virginia King and Queen County",6945,6945,0,8.5089032182903,816203901
"2961","Virginia King George County",23584,17261,6323,50.6904030095742,465255721
"2962","Virginia King William County",15935,13260,2675,22.4593334620635,709504582
"2963","Virginia Lancaster County",11391,11391,0,33.0063080731083,345115848
"2964","Virginia Lee County",25587,25475,112,22.6837684047371,1127987182
"2965","Virginia Lexington city",7042,0,7042,1088.92304552076,6466940
"2966","Virginia Loudoun County",312311,39354,272957,233.888742640972,1335297272
"2967","Virginia Louisa County",33153,33153,0,25.7917374914484,1285411656
"2968","Virginia Lunenburg County",12914,12914,0,11.5504229191287,1118054299
"2969","Virginia Lynchburg city",75568,2034,73534,593.902703179182,127239697
"2970","Virginia Madison County",13308,13308,0,16.0228142914575,830565702
"2971","Virginia Manassas city",37821,0,37821,1477.91029946899,25590863
"2972","Virginia Manassas Park city",14273,0,14273,2174.96846425253,6562394
"2973","Virginia Martinsville city",13821,0,13821,487.055893196582,28376620
"2974","Virginia Mathews County",8978,8978,0,40.3405087616637,222555448
"2975","Virginia Mecklenburg County",32727,25465,7262,20.2018664296184,1619998831
"2976","Virginia Middlesex County",10959,10959,0,32.4718590703183,337492226
"2977","Virginia Montgomery County",94392,23528,70864,94.1696472880111,1002361193
"2978","Virginia Nelson County",15020,15020,0,12.3164204829462,1219510167
"2979","Virginia New Kent County",18429,18429,0,33.9269462144187,543196546
"2980","Virginia Newport News city",180719,51,180668,1015.45918169765,177967764
"2981","Virginia Norfolk city",242803,0,242803,1732.18777399735,140171293
"2982","Virginia Northampton County",12389,12389,0,22.6046520399442,548073024
"2983","Virginia Northumberland County",12330,12330,0,24.8863571464244,495452184
"2984","Virginia Norton city",3958,102,3856,204.280349438105,19375334
"2985","Virginia Nottoway County",15853,8298,7555,19.4689308684079,814271729
"2986","Virginia Orange County",33481,19345,14136,37.9334776754975,882624058
"2987","Virginia Page County",24042,19272,4770,29.8616582110243,805112691
"2988","Virginia Patrick County",18490,18490,0,14.7776695145871,1251212174
"2989","Virginia Petersburg city",32420,683,31737,545.855094296215,59393052
"2990","Virginia Pittsylvania County",63506,54380,9126,25.3057767140548,2509545576
"2991","Virginia Poquoson city",12150,790,11360,306.278003325549,39669842
"2992","Virginia Portsmouth city",95535,0,95535,1096.08808245749,87159966
"2993","Virginia Powhatan County",28046,27955,91,41.6131602873175,673969480
"2994","Virginia Prince Edward County",23368,14771,8597,25.7813275524671,906392425
"2995","Virginia Prince George County",35725,19078,16647,52.0204438990317,686749234
"2996","Virginia Prince William County",402002,16748,385254,461.394504167566,871276091
"2997","Virginia Pulaski County",34872,16356,18516,42.0942043378411,828427584
"2998","Virginia Radford city",16408,481,15927,641.761110137205,25567146
"2999","Virginia Rappahannock County",7373,7373,0,10.6928678446752,689525028
"3000","Virginia Richmond city",204214,0,204214,1318.40529991003,154894705
"3001","Virginia Richmond County",9254,9254,0,18.6586566737832,495962821
"3002","Virginia Roanoke city",97032,6,97026,880.235110369801,110234185
"3003","Virginia Roanoke County",92376,17127,75249,142.371417022609,648838102
"3004","Virginia Rockbridge County",22307,20442,1865,14.4132926247812,1547668571
"3005","Virginia Rockingham County",76314,45279,31035,34.7020379633729,2199121564
"3006","Virginia Russell County",28897,25483,3414,23.5472361264345,1227192858
"3007","Virginia Salem city",24802,0,24802,663.322081302608,37390584
"3008","Virginia Scott County",23177,19034,4143,16.7099582220619,1387017232
"3009","Virginia Shenandoah County",41993,27961,14032,31.86785124169,1317722983
"3010","Virginia Smyth County",32208,24248,7960,27.5777549762587,1167897823
"3011","Virginia Southampton County",18570,18192,378,11.9669250893959,1551777074
"3012","Virginia Spotsylvania County",122397,39568,82829,117.704057992057,1039870690
"3013","Virginia Stafford County",128961,25476,103485,185.131342886223,696591933
"3014","Virginia Staunton city",23746,877,22869,458.988375780158,51735515
"3015","Virginia Suffolk city",84585,18298,66287,81.6119088467892,1036429624
"3016","Virginia Surry County",7058,7058,0,9.76918574062465,722475771
"3017","Virginia Sussex County",12087,12087,0,9.5198399477913,1269664203
"3018","Virginia Tazewell County",45078,23390,21688,33.5450434763015,1343805085
"3019","Virginia Virginia Beach city",437994,6721,431273,679.11427202443,644948896
"3020","Virginia Warren County",37575,18941,18634,67.9632522595552,552872306
"3021","Virginia Washington County",54876,39333,15543,37.769511855365,1452917904
"3022","Virginia Waynesboro city",21006,531,20475,539.295491542578,38950817
"3023","Virginia Westmoreland County",17454,13761,3693,29.3800097333107,594077407
"3024","Virginia Williamsburg city",14068,0,14068,602.046057892882,23366983
"3025","Virginia Winchester city",26203,0,26203,1095.78163589079,23912611
"3026","Virginia Wise County",41452,23491,17961,39.6953446459096,1044253435
"3027","Virginia Wythe County",29235,22023,7212,24.4415566018199,1196118581
"3028","Virginia York County",65464,3993,61471,241.22682426662,271379438
"3029","Washington Adams County",18728,7521,11207,3.75636665135588,4985668796
"3030","Washington Asotin County",21623,1439,20184,13.122472267318,1647784012
"3031","Washington Benton County",175177,18518,156659,39.7771435356995,4403961281
"3032","Washington Chelan County",72453,19725,52728,9.57850422691679,7564124657
"3033","Washington Clallam County",71404,25315,46089,15.8596211809186,4502251295
"3034","Washington Clark County",425363,58566,366797,261.101029815442,1629112686
"3035","Washington Columbia County",4078,1397,2681,1.81265486708891,2249738808
"3036","Washington Cowlitz County",102410,29342,73068,34.6810360696091,2952910628
"3037","Washington Douglas County",38431,10221,28210,8.15620581500954,4711872269
"3038","Washington Ferry County",7551,7551,0,1.32330801745321,5706154501
"3039","Washington Franklin County",78163,10422,67741,24.2952876319516,3217208258
"3040","Washington Garfield County",2266,2266,0,1.23107403630902,1840669150
"3041","Washington Grant County",89120,34533,54587,12.8416703302964,6939907170
"3042","Washington Grays Harbor County",72797,29201,43596,14.77743864529,4926225833
"3043","Washington Island County",78506,36816,41690,145.413886427502,539879663
"3044","Washington Jefferson County",29872,17167,12705,6.39443539723335,4671561779
"3045","Washington King County",1931249,61938,1869311,352.463250237527,5479291809
"3046","Washington Kitsap County",251133,42044,209089,245.512446250105,1022893152
"3047","Washington Kittitas County",40915,16389,24526,6.87658161440157,5949903934
"3048","Washington Klickitat County",20318,12234,8084,4.19214869484653,4846679228
"3049","Washington Lewis County",75455,45767,29688,12.1247337011459,6223229463
"3050","Washington Lincoln County",10570,10570,0,1.76633215190472,5984151955
"3051","Washington Mason County",60699,38663,22036,24.4273490159417,2484878730
"3052","Washington Okanogan County",41120,32891,8229,3.01377912583851,13643999206
"3053","Washington Pacific County",20920,13550,7370,8.66047300354809,2415572451
"3054","Washington Pend Oreille County",13001,10805,2196,3.5855378254876,3625955333
"3055","Washington Pierce County",795225,52411,742814,183.909348621961,4324005310
"3056","Washington San Juan County",15769,15769,0,35.0082202160512,450437066
"3057","Washington Skagit County",116901,33926,82975,26.0718880554518,4483794950
"3058","Washington Skamania County",11066,11066,0,2.58057989867549,4288183445
"3059","Washington Snohomish County",713335,77179,636156,131.952136475557,5406013264
"3060","Washington Spokane County",471221,64424,406797,103.152475670723,4568198649
"3061","Washington Stevens County",43531,34479,9052,6.7832970872474,6417380728
"3062","Washington Thurston County",252264,52947,199317,134.909803495724,1869871525
"3063","Washington Wahkiakum County",3978,3978,0,5.83165737076098,682138841
"3064","Washington Walla Walla County",58781,10066,48715,17.8686350969015,3289618915
"3065","Washington Whatcom County",201140,52042,149098,36.8608794211215,5456733620
"3066","Washington Whitman County",44776,12327,32449,8.00713026724284,5592015929
"3067","Washington Yakima County",243231,57206,186025,21.863414842544,11125023321
"3068","West Virginia Barbour County",16589,13889,2700,18.779883585982,883338809
"3069","West Virginia Berkeley County",104169,32944,71225,125.240085577082,831754462
"3070","West Virginia Boone County",24629,20050,4579,18.9600999135448,1298991045
"3071","West Virginia Braxton County",14523,14523,0,10.9773504244791,1322996847
"3072","West Virginia Brooke County",24069,10140,13929,104.17731197509,231038789
"3073","West Virginia Cabell County",96319,20765,75554,132.33680922759,727832268
"3074","West Virginia Calhoun County",7627,7627,0,10.5454211996152,723252287
"3075","West Virginia Clay County",9386,9386,0,10.5993924709651,885522451
"3076","West Virginia Doddridge County",8202,8202,0,9.90494888851946,828070906
"3077","West Virginia Fayette County",46039,26644,19395,26.8698719148708,1713406009
"3078","West Virginia Gilmer County",8693,5278,3415,9.91539447001923,876717515
"3079","West Virginia Grant County",11937,9392,2545,9.65471147720136,1236391168
"3080","West Virginia Greenbrier County",35480,24742,10738,13.4359764224501,2640671499
"3081","West Virginia Hampshire County",23964,23964,0,14.4514964900919,1658236572
"3082","West Virginia Hancock County",30676,9298,21378,143.374466605948,213957204
"3083","West Virginia Hardy County",14025,11293,2732,9.2992753974773,1508182025
"3084","West Virginia Harrison County",69099,25601,43498,64.1316950181107,1077454759
"3085","West Virginia Jackson County",29211,20868,8343,24.288761459362,1202654983
"3086","West Virginia Jefferson County",53498,25879,27619,98.5318973829685,542951079
"3087","West Virginia Kanawha County",193063,48629,144434,82.678670275344,2335100448
"3088","West Virginia Lewis County",16372,11295,5077,16.4233274804849,996874721
"3089","West Virginia Lincoln County",21720,21720,0,19.1885587847197,1131924510
"3090","West Virginia Logan County",36743,25996,10747,31.2660209319011,1175173524
"3091","West Virginia Marion County",56418,23404,33014,70.5559328405816,799620921
"3092","West Virginia Marshall County",33107,16220,16887,41.8512995881536,791062651
"3093","West Virginia Mason County",27324,17763,9561,24.4919260901005,1115632960
"3094","West Virginia McDowell County",22113,19015,3098,16.0048523892614,1381643483
"3095","West Virginia Mercer County",62264,25361,36903,57.3762780509724,1085187156
"3096","West Virginia Mineral County",28212,18223,9989,33.2267438971206,849075073
"3097","West Virginia Mingo County",26839,24085,2754,24.4915698746241,1095846454
"3098","West Virginia Monongalia County",96189,25839,70350,103.145484434082,932556578
"3099","West Virginia Monroe County",13502,11952,1550,11.027241695598,1224422242
"3100","West Virginia Morgan County",17541,17541,0,29.565370994664,593295447
"3101","West Virginia Nicholas County",26233,22864,3369,15.6590044851023,1675266140
"3102","West Virginia Ohio County",44443,10263,34180,162.157542757207,274072974
"3103","West Virginia Pendleton County",7695,7695,0,4.26845601111844,1802759588
"3104","West Virginia Pleasants County",7605,4142,3463,22.5690194669144,336966345
"3105","West Virginia Pocahontas County",8719,8719,0,3.58022237641966,2435323587
"3106","West Virginia Preston County",33520,30319,3201,19.9476778717461,1680396095
"3107","West Virginia Putnam County",55486,19855,35631,61.9761946382599,895279233
"3108","West Virginia Raleigh County",78859,30959,47900,50.2975092666268,1567850996
"3109","West Virginia Randolph County",29405,18344,11061,10.9200186697299,2692760964
"3110","West Virginia Ritchie County",10449,10449,0,8.9258094026089,1170650137
"3111","West Virginia Roane County",14926,11940,2986,11.9177110556384,1252421705
"3112","West Virginia Summers County",13927,10045,3882,14.9177354105999,933586742
"3113","West Virginia Taylor County",16895,10087,6808,37.7563026096477,447474960
"3114","West Virginia Tucker County",7141,7141,0,6.58154220470206,1085004058
"3115","West Virginia Tyler County",9208,8384,824,13.8717061398006,663797222
"3116","West Virginia Upshur County",24254,15523,8731,26.4058982707119,918506909
"3117","West Virginia Wayne County",42481,27692,14789,32.4162179321919,1310486007
"3118","West Virginia Webster County",9154,9154,0,6.38587595702299,1433476012
"3119","West Virginia Wetzel County",16583,8931,7652,17.88159069222,927378346
"3120","West Virginia Wirt County",5717,5717,0,9.49359952795239,602195193
"3121","West Virginia Wood County",86956,23282,63674,91.666964594492,948607826
"3122","West Virginia Wyoming County",23796,21151,2645,18.3954931252113,1293577717
"3123","Wisconsin Adams County",20875,20875,0,12.4834488007198,1672214172
"3124","Wisconsin Ashland County",16157,8864,7293,5.96941971907496,2706628242
"3125","Wisconsin Barron County",45870,30241,15629,20.5288956733391,2234411472
"3126","Wisconsin Bayfield County",15014,15014,0,3.92251413739579,3827647135
"3127","Wisconsin Brown County",248007,35947,212060,180.771256348183,1371938244
"3128","Wisconsin Buffalo County",13587,13587,0,7.8107457826027,1739526593
"3129","Wisconsin Burnett County",15457,15457,0,7.26166438902827,2128575375
"3130","Wisconsin Calumet County",48971,13484,35487,59.4144273654998,824227417
"3131","Wisconsin Chippewa County",62415,28800,33615,23.8984771097024,2611672690
"3132","Wisconsin Clark County",34690,31821,2869,11.0710150583249,3133407354
"3133","Wisconsin Columbia County",56833,34481,22352,28.664281415274,1982711486
"3134","Wisconsin Crawford County",16644,10389,6255,11.2611486945145,1478001974
"3135","Wisconsin Dane County",488073,60179,427894,157.400459633349,3100835926
"3136","Wisconsin Dodge County",88759,43174,45585,39.1378145162787,2267857853
"3137","Wisconsin Door County",27785,19168,8617,22.2579835515785,1248316135
"3138","Wisconsin Douglas County",44159,17114,27045,13.0736975146922,3377697851
"3139","Wisconsin Dunn County",43857,26013,17844,19.9190448269854,2201762202
"3140","Wisconsin Eau Claire County",98736,22710,76026,59.7542043701453,1652369085
"3141","Wisconsin Florence County",4423,4423,0,3.49804677032471,1264419915
"3142","Wisconsin Fond du Lac County",101633,35703,65930,54.5348752587771,1863633125
"3143","Wisconsin Forest County",9304,9304,0,3.54246293474466,2626421270
"3144","Wisconsin Grant County",51208,33023,18185,17.239866396651,2970324643
"3145","Wisconsin Green County",36842,22185,14657,24.3592994634414,1512440867
"3146","Wisconsin Green Lake County",19051,14160,4891,21.0499564702568,905037501
"3147","Wisconsin Iowa County",23687,18931,4756,11.9929766046585,1975072643
"3148","Wisconsin Iron County",5916,4011,1905,3.01273998365208,1963660997
"3149","Wisconsin Jackson County",20449,14772,5677,7.99356639436858,2558182292
"3150","Wisconsin Jefferson County",83686,28496,55190,58.0644744271679,1441259924
"3151","Wisconsin Juneau County",26664,22263,4401,13.4237713308038,1986327042
"3152","Wisconsin Kenosha County",166426,17846,148580,236.248870231828,704452046
"3153","Wisconsin Kewaunee County",20574,14882,5692,23.1919466153628,887118289
"3154","Wisconsin La Crosse County",114638,19291,95347,97.9927046099135,1169862598
"3155","Wisconsin Lafayette County",16836,16836,0,10.2596892681257,1640985371
"3156","Wisconsin Langlade County",19977,11819,8158,8.85918882655069,2254946857
"3157","Wisconsin Lincoln County",28743,15535,13208,12.6257942488507,2276530049
"3158","Wisconsin Manitowoc County",81442,31650,49792,53.3795214955008,1525716187
"3159","Wisconsin Marathon County",134063,57634,76429,33.5032865345103,4001488029
"3160","Wisconsin Marinette County",41749,25813,15936,11.5192115188036,3624293202
"3161","Wisconsin Marquette County",15404,15404,0,13.0541960236007,1180003730
"3162","Wisconsin Menominee County",4232,4232,0,4.5692021915686,926201079
"3163","Wisconsin Milwaukee County",947735,1820,945915,1515.82085789557,625228895
"3164","Wisconsin Monroe County",44673,25764,18909,19.1483227416472,2332998070
"3165","Wisconsin Oconto County",37660,30634,7026,14.569929629979,2584775696
"3166","Wisconsin Oneida County",35998,26988,9010,12.4881239495404,2882578692
"3167","Wisconsin Outagamie County",176695,43712,132983,107.011497936834,1651177709
"3168","Wisconsin Ozaukee County",86395,21501,64894,143.117092900717,603666538
"3169","Wisconsin Pepin County",7469,7469,0,12.4310547266607,600833973
"3170","Wisconsin Pierce County",41019,22006,19013,27.6036435388206,1485999482
"3171","Wisconsin Polk County",44205,37780,6425,18.6743491785902,2367150768
"3172","Wisconsin Portage County",70019,25229,44790,33.7644715925368,2073747839
"3173","Wisconsin Price County",14159,14159,0,4.35820047017229,3248817969
"3174","Wisconsin Racine County",195408,23992,171416,226.909023962796,861173331
"3175","Wisconsin Richland County",18021,13000,5021,11.8705742222145,1518123695
"3176","Wisconsin Rock County",160331,32734,127597,86.2003879074983,1859980029
"3177","Wisconsin Rusk County",14755,11306,3449,6.23580429770035,2366174321
"3178","Wisconsin Sauk County",61976,28600,33376,28.7989094733641,2152025932
"3179","Wisconsin Sawyer County",16557,13941,2616,5.08444350922867,3256403571
"3180","Wisconsin Shawano County",41949,31207,10742,18.1361294216815,2313007314
"3181","Wisconsin Sheboygan County",115507,32671,82836,87.229647497833,1324171349
"3182","Wisconsin St. Croix County",84345,44845,39500,45.0844033027855,1870824361
"3183","Wisconsin Taylor County",20689,16643,4046,8.1939300665911,2524917815
"3184","Wisconsin Trempealeau County",28816,25823,2993,15.1793378957916,1898370021
"3185","Wisconsin Vernon County",29773,25513,4260,14.5221376352864,2050180266
"3186","Wisconsin Vilas County",21430,21430,0,9.65926680768721,2218594892
"3187","Wisconsin Walworth County",102228,34959,67269,71.1017040094249,1437771449
"3188","Wisconsin Washburn County",15911,13238,2673,7.70690176821659,2064513144
"3189","Wisconsin Washington County",131887,40601,91286,118.229674976263,1115515204
"3190","Wisconsin Waukesha County",389891,38445,351446,273.91739358005,1423388982
"3191","Wisconsin Waupaca County",52410,34035,18375,27.0633563908603,1936566893
"3192","Wisconsin Waushara County",24496,21923,2573,15.1048620485855,1621729475
"3193","Wisconsin Winnebago County",166994,22429,144565,148.397395877632,1125316243
"3194","Wisconsin Wood County",74749,27420,47329,36.3890462728758,2054162108
"3195","Wyoming Albany County",36299,4334,31965,3.27928125038239,11069193896
"3196","Wyoming Big Horn County",11668,11668,0,1.436053809399,8125043730
"3197","Wyoming Campbell County",46133,13412,32721,3.7087507827762,12438959289
"3198","Wyoming Carbon County",15885,6613,9272,0.776596715196084,20454631972
"3199","Wyoming Converse County",13833,7658,6175,1.25525217512164,11020096419
"3200","Wyoming Crook County",7083,7083,0,0.958083763001764,7392881785
"3201","Wyoming Fremont County",40123,20633,19490,1.68683484384947,23785968227
"3202","Wyoming Goshen County",13249,6094,7155,2.29868268751537,5763735931
"3203","Wyoming Hot Springs County",4812,1515,3297,0.927065277228314,5190573003
"3204","Wyoming Johnson County",8569,4201,4368,0.796434226208173,10759206119
"3205","Wyoming Laramie County",91738,18150,73588,13.1874175439155,6956479515
"3206","Wyoming Lincoln County",18106,14979,3127,1.7150500286544,10557126438
"3207","Wyoming Natrona County",75450,10902,64548,5.45496080372004,13831446772
"3208","Wyoming Niobrara County",2484,2484,0,0.365218694239875,6801404307
"3209","Wyoming Park County",28205,12478,15727,1.56869636306116,17979897617
"3210","Wyoming Platte County",8667,5083,3584,1.60557275002055,5398073678
"3211","Wyoming Sheridan County",29116,10330,18786,4.45395409637823,6537112725
"3212","Wyoming Sublette County",10247,10247,0,0.809650887825202,12656072085
"3213","Wyoming Sweetwater County",43806,4782,39024,1.62215024731034,27004896786
"3214","Wyoming Teton County",21294,9887,11407,2.05779216802795,10347983791
"3215","Wyoming Uinta County",21118,9101,12017,3.9176695310734,5390449560
"3216","Wyoming Washakie County",8533,3068,5465,1.47176144179913,5797814617
"3217","Wyoming Weston County",7208,3931,3277,1.16051776773915,6211020805
"3218",NA,13586,10866,2720,2.50517683055356,5423170067
